GEOID10,POP_2010,POP_WHITE,POP_BLACK,POP_NATV,POP_ASN,POP_ISLND,POP_OTHER,POP_MULTI,NOT_HISP,NH_WHITE,NH_BLACK,NH_NATV,NH_ASN,NH_ISLND,NH_OTHER,NH_MULTI,HISP,H_WHITE,H_BLACK,H_NATV,H_ASN,H_ISLND,H_OTHER,H_MULTI
250039251002,2059,1875,71,3,41,0,18,51,1976,1821,63,3,41,0,6,42,83,54,8,0,0,0,12,9
250039251003,793,705,35,3,10,0,29,11,725,662,35,3,10,0,7,8,68,43,0,0,0,0,22,3
250039251004,659,582,15,5,7,0,23,27,586,537,15,5,7,0,3,19,73,45,0,0,0,0,20,8
250039251005,710,650,10,4,18,0,13,15,677,632,10,0,18,0,3,14,33,18,0,4,0,0,10,1
250039251006,1198,1058,39,9,31,0,28,33,1104,1008,35,1,31,0,4,25,94,50,4,8,0,0,24,8
250039251007,1127,1051,17,1,14,1,13,30,1087,1028,17,0,14,1,1,26,40,23,0,1,0,0,12,4
250039261001,1099,1062,6,3,1,0,17,10,1069,1049,6,3,1,0,1,9,30,13,0,0,0,0,16,1
250039261002,537,507,7,3,2,0,7,11,523,505,7,2,2,0,0,7,14,2,0,1,0,0,7,4
250039261003,729,702,9,1,4,0,6,7,703,687,8,0,4,0,1,3,26,15,1,1,0,0,5,4
250039261004,892,850,14,0,4,0,11,13,857,829,13,0,4,0,0,11,35,21,1,0,0,0,11,2
250039311001,695,687,0,0,0,0,0,8,692,686,0,0,0,0,0,6,3,1,0,0,0,0,0,2
250039311002,1007,995,3,0,2,0,0,7,994,982,3,0,2,0,0,7,13,13,0,0,0,0,0,0
250039313001,752,730,6,2,6,0,0,8,747,726,5,2,6,0,0,8,5,4,1,0,0,0,0,0
250039313002,692,649,13,4,2,0,0,24,683,644,13,4,1,0,0,21,9,5,0,0,1,0,0,3
250039314001,899,864,6,2,5,0,1,21,895,861,6,1,5,0,1,21,4,3,0,1,0,0,0,0
250039314002,847,829,8,3,3,0,0,4,847,829,8,3,3,0,0,4,0,0,0,0,0,0,0,0
250039322001,538,533,1,0,0,0,3,1,528,526,1,0,0,0,0,1,10,7,0,0,0,0,3,0
250039322002,1071,1034,5,1,6,0,10,15,1047,1017,5,0,6,0,4,15,24,17,0,1,0,0,6,0
250039322003,708,685,6,4,2,0,6,5,699,682,6,4,2,0,0,5,9,3,0,0,0,0,6,0
250039323001,637,617,7,0,1,0,2,10,629,611,7,0,1,0,0,10,8,6,0,0,0,0,2,0
250039323002,1395,1370,1,4,6,0,2,12,1385,1365,1,1,6,0,0,12,10,5,0,3,0,0,2,0
250039332001,327,320,3,1,3,0,0,0,324,318,3,0,3,0,0,0,3,2,0,1,0,0,0,0
250039332002,961,940,14,0,1,0,4,2,955,938,14,0,1,0,0,2,6,2,0,0,0,0,4,0
250039333001,931,896,17,1,8,0,1,8,916,886,13,1,8,0,0,8,15,10,4,0,0,0,1,0
250039333002,578,561,5,0,4,0,4,4,566,553,5,0,4,0,0,4,12,8,0,0,0,0,4,0
250039334001,754,732,0,3,4,0,4,11,743,725,0,3,4,0,1,10,11,7,0,0,0,0,3,1
250039334002,858,841,2,1,5,0,0,9,851,834,2,1,5,0,0,9,7,7,0,0,0,0,0,0
250039334003,915,882,8,1,7,2,3,12,905,875,8,0,7,2,2,11,10,7,0,1,0,0,1,1
250039342001,548,524,7,0,10,0,4,3,542,523,6,0,10,0,0,3,6,1,1,0,0,0,4,0
250039342002,758,730,8,0,8,0,1,11,752,727,8,0,8,0,1,8,6,3,0,0,0,0,0,3
250039343001,494,483,3,0,3,0,0,5,492,481,3,0,3,0,0,5,2,2,0,0,0,0,0,0
250039343002,1392,1350,8,1,7,1,7,18,1362,1334,8,1,7,1,0,11,30,16,0,0,0,0,7,7
250039351001,228,214,2,0,3,0,1,8,227,214,2,0,3,0,0,8,1,0,0,0,0,0,1,0
250039351002,717,689,6,1,6,0,3,12,704,686,5,0,6,0,0,7,13,3,1,1,0,0,3,5
250039351003,889,864,4,3,7,0,1,10,872,850,3,3,6,0,1,9,17,14,1,0,1,0,0,1
250039351004,586,576,1,2,2,0,3,2,581,574,1,1,2,0,1,2,5,2,0,1,0,0,2,0
250039352001,1529,1364,110,4,17,0,14,20,1511,1357,110,4,17,0,4,19,18,7,0,0,0,0,10,1
250039352002,1031,995,15,0,5,0,1,15,1015,983,12,0,5,0,0,15,16,12,3,0,0,0,1,0
250039352003,961,852,58,0,7,0,13,31,918,831,55,0,7,0,0,25,43,21,3,0,0,0,13,6
250039352004,683,656,13,1,3,0,1,9,672,648,12,1,3,0,0,8,11,8,1,0,0,0,1,1
250039352005,917,879,13,1,20,1,0,3,912,874,13,1,20,1,0,3,5,5,0,0,0,0,0,0
250039353001,1039,971,21,0,14,0,2,31,1019,957,21,0,14,0,1,26,20,14,0,0,0,0,1,5
250039353002,1323,1229,28,10,7,0,15,34,1269,1207,20,10,7,0,0,25,54,22,8,0,0,0,15,9
250039353003,988,951,11,1,3,0,9,13,962,933,11,1,3,0,1,13,26,18,0,0,0,0,8,0
250039353004,441,418,12,3,1,0,2,5,431,411,12,1,1,0,1,5,10,7,0,2,0,0,1,0
250056001001,2224,2116,45,1,30,0,6,26,2170,2071,45,1,30,0,3,20,54,45,0,0,0,0,3,6
250056001002,1696,1558,49,3,33,2,30,21,1656,1528,49,3,33,2,23,18,40,30,0,0,0,0,7,3
250056002021,2823,2506,92,1,102,0,61,61,2745,2458,92,1,102,0,41,51,78,48,0,0,0,0,20,10
250056002022,816,745,17,0,30,0,9,15,797,735,17,0,30,0,0,15,19,10,0,0,0,0,9,0
250056002023,842,749,51,0,11,1,7,23,818,736,51,0,11,1,2,17,24,13,0,0,0,0,5,6
250056002031,1805,1656,62,4,40,0,7,36,1782,1646,58,4,39,0,3,32,23,10,4,0,1,0,4,4
250056002032,927,873,25,4,16,0,6,3,902,854,25,4,16,0,0,3,25,19,0,0,0,0,6,0
250056002033,2879,2693,60,1,83,0,15,27,2824,2651,55,0,83,0,8,27,55,42,5,1,0,0,7,0
250056002041,1790,1553,80,3,75,0,33,46,1740,1528,80,3,75,0,12,42,50,25,0,0,0,0,21,4
250056002042,2105,1831,130,1,67,1,18,57,2047,1804,125,0,67,1,4,46,58,27,5,1,0,0,14,11
250056101001,1833,1655,54,2,88,0,11,23,1807,1641,53,2,88,0,1,22,26,14,1,0,0,0,10,1
250056101002,2091,1918,48,4,74,0,17,30,2038,1885,43,4,74,0,7,25,53,33,5,0,0,0,10,5
250056101003,1179,1118,30,0,11,0,6,14,1156,1102,28,0,11,0,2,13,23,16,2,0,0,0,4,1
250056102021,2051,1954,18,0,39,4,9,27,2019,1930,18,0,39,0,5,27,32,24,0,0,0,4,4,0
250056102022,1185,1061,36,0,47,0,15,26,1145,1040,34,0,47,0,4,20,40,21,2,0,0,0,11,6
250056102023,1364,1268,41,2,39,0,4,10,1353,1259,39,2,39,0,4,10,11,9,2,0,0,0,0,0
250056102024,986,904,23,5,33,0,6,15,971,890,23,5,33,0,5,15,15,14,0,0,0,0,1,0
250056102031,1427,1329,22,0,41,0,3,32,1404,1313,22,0,41,0,0,28,23,16,0,0,0,0,3,4
250056102032,1560,1486,24,4,25,0,3,18,1547,1473,24,4,25,0,3,18,13,13,0,0,0,0,0,0
250056102033,2767,2594,44,7,75,0,21,26,2704,2548,42,7,73,0,14,20,63,46,2,0,2,0,7,6
250056102034,1129,1086,14,0,13,0,4,12,1100,1067,13,0,13,0,0,7,29,19,1,0,0,0,4,5
250056102041,2059,1867,65,0,96,4,3,24,2031,1846,61,0,96,4,0,24,28,21,4,0,0,0,3,0
250056102042,1850,1687,59,1,61,0,16,26,1787,1647,52,1,61,0,7,19,63,40,7,0,0,0,9,7
250056102043,1703,1300,156,34,151,0,23,39,1635,1258,149,34,151,0,8,35,68,42,7,0,0,0,15,4
250056111011,2780,2621,53,2,40,0,27,37,2722,2585,51,2,36,0,14,34,58,36,2,0,4,0,13,3
250056111012,1805,1716,24,6,25,0,3,31,1781,1697,23,6,24,0,2,29,24,19,1,0,1,0,1,2
250056111021,2770,2456,100,3,95,3,46,67,2662,2413,85,1,94,3,11,55,108,43,15,2,1,0,35,12
250056111022,2277,2165,47,7,38,0,6,14,2254,2150,44,7,38,0,1,14,23,15,3,0,0,0,5,0
250056112011,826,789,11,0,10,0,3,13,813,782,9,0,10,0,1,11,13,7,2,0,0,0,2,2
250010101001,763,727,11,5,4,1,3,12,726,702,10,3,4,0,0,7,37,25,1,2,0,1,3,5
250010101002,494,459,13,3,7,0,8,4,479,449,13,3,7,0,3,4,15,10,0,0,0,0,5,0
250010101003,569,522,22,3,1,0,9,12,536,496,21,2,1,0,4,12,33,26,1,1,0,0,5,0
250010101004,516,449,42,7,2,0,11,5,496,444,41,3,2,0,1,5,20,5,1,4,0,0,10,0
250010101005,600,534,30,0,4,0,15,17,563,512,29,0,4,0,1,17,37,22,1,0,0,0,14,0
250010102061,660,648,6,1,2,0,2,1,655,644,6,1,2,0,1,1,5,4,0,0,0,0,1,0
250010102062,911,876,8,2,4,0,10,11,900,871,8,2,4,0,4,11,11,5,0,0,0,0,6,0
250010102063,1179,1142,8,4,7,0,3,15,1154,1120,8,4,7,0,2,13,25,22,0,0,0,0,1,2
250010102081,787,753,12,2,8,0,3,9,774,743,12,2,8,0,0,9,13,10,0,0,0,0,3,0
250010102082,603,569,22,1,0,0,1,10,598,567,21,0,0,0,0,10,5,2,1,1,0,0,1,0
250010102083,613,589,5,1,2,0,5,11,590,573,5,1,2,0,4,5,23,16,0,0,0,0,1,6
250010103041,1066,1040,5,0,11,0,1,9,1053,1027,5,0,11,0,1,9,13,13,0,0,0,0,0,0
250010103042,742,721,5,6,4,0,1,5,722,702,5,6,3,0,1,5,20,19,0,0,1,0,0,0
250010103043,613,590,7,0,2,0,4,10,606,587,7,0,2,0,3,7,7,3,0,0,0,0,1,3
250010103061,920,898,1,3,2,3,2,11,903,888,1,3,2,0,1,8,17,10,0,0,0,3,1,3
250010103062,918,879,13,1,5,0,4,16,909,873,13,1,5,0,1,16,9,6,0,0,0,0,3,0
250010103063,697,682,3,2,5,0,0,5,688,673,3,2,5,0,0,5,9,9,0,0,0,0,0,0
250010104001,766,741,6,1,4,0,2,12,757,734,6,1,4,0,0,12,9,7,0,0,0,0,2,0
250010104002,758,719,11,2,2,0,9,15,738,706,10,1,2,0,6,13,20,13,1,1,0,0,3,2
250010104003,638,588,19,2,14,0,7,8,627,584,18,2,13,0,5,5,11,4,1,0,1,0,2,3
250010104004,837,814,3,0,7,0,4,9,816,797,3,0,7,0,1,8,21,17,0,0,0,0,3,1
250010105001,1233,1194,4,0,12,1,6,16,1221,1185,3,0,12,1,4,16,12,9,1,0,0,0,2,0
250010105002,840,834,0,0,4,0,0,2,835,829,0,0,4,0,0,2,5,5,0,0,0,0,0,0
250010105003,818,798,10,2,2,0,2,4,815,795,10,2,2,0,2,4,3,3,0,0,0,0,0,0
250010106001,614,603,4,1,2,0,1,3,610,601,4,1,2,0,0,2,4,2,0,0,0,0,1,1
250010106002,807,786,8,4,4,0,1,4,799,781,8,4,4,0,0,2,8,5,0,0,0,0,1,2
250010106003,1125,1044,31,3,4,0,18,25,1093,1028,26,3,4,0,10,22,32,16,5,0,0,0,8,3
250010106004,427,408,11,0,5,0,0,3,421,402,11,0,5,0,0,3,6,6,0,0,0,0,0,0
250010107001,930,895,10,0,8,0,9,8,917,891,10,0,8,0,0,8,13,4,0,0,0,0,9,0
250010107002,837,812,11,1,5,0,5,3,825,801,11,1,5,0,4,3,12,11,0,0,0,0,1,0
250010107003,752,728,9,0,4,0,2,9,727,704,9,0,4,0,1,9,25,24,0,0,0,0,1,0
250010107004,633,609,2,7,4,0,2,9,625,603,2,6,4,0,1,9,8,6,0,1,0,0,1,0
250010108001,863,839,4,0,9,0,3,8,845,822,4,0,8,0,3,8,18,17,0,0,1,0,0,0
250010108002,529,521,2,0,1,0,4,1,527,521,2,0,1,0,2,1,2,0,0,0,0,0,2,0
250010108003,768,729,4,0,21,0,3,11,758,724,3,0,21,0,0,10,10,5,1,0,0,0,3,1
250010108004,702,685,2,5,8,0,0,2,690,674,1,5,8,0,0,2,12,11,1,0,0,0,0,0
250010108005,2016,1952,11,4,7,0,10,32,1989,1939,10,4,6,0,1,29,27,13,1,0,1,0,9,3
250010109001,1826,1762,17,1,9,2,23,12,1773,1721,16,1,9,0,17,9,53,41,1,0,0,2,6,3
250010109002,1043,1013,6,5,9,0,5,5,1025,998,6,3,9,0,5,4,18,15,0,2,0,0,0,1
250010109003,1362,1297,20,0,22,0,1,22,1348,1284,20,0,22,0,1,21,14,13,0,0,0,0,0,1
250010109004,711,698,5,0,2,0,1,5,699,687,5,0,2,0,0,5,12,11,0,0,0,0,1,0
250010110021,673,618,28,0,1,0,21,5,656,607,28,0,1,0,15,5,17,11,0,0,0,0,6,0
250010110022,810,751,28,10,3,2,6,10,805,748,28,8,3,2,6,10,5,3,0,2,0,0,0,0
250010110023,502,467,4,1,3,0,11,16,490,461,4,0,3,0,8,14,12,6,0,1,0,0,3,2
250010110024,2172,1973,28,14,10,0,99,48,2137,1962,28,12,7,0,81,47,35,11,0,2,3,0,18,1
250010111001,979,932,11,3,7,0,7,19,968,922,11,3,7,0,6,19,11,10,0,0,0,0,1,0
250010111002,1070,1026,7,1,12,0,6,18,1057,1019,7,0,12,0,1,18,13,7,0,1,0,0,5,0
250010111003,1531,1434,22,10,21,0,9,35,1498,1411,21,6,21,0,8,31,33,23,1,4,0,0,1,4
250010111004,1114,1019,23,2,5,0,27,38,1097,1016,23,1,5,0,16,36,17,3,0,1,0,0,11,2
250010112001,1149,1095,15,3,8,0,11,17,1141,1091,12,3,8,0,10,17,8,4,3,0,0,0,1,0
250010112002,1126,1063,20,8,8,0,16,11,1104,1048,20,4,8,0,14,10,22,15,0,4,0,0,2,1
250010112003,523,497,3,0,0,0,15,8,521,495,3,0,0,0,15,8,2,2,0,0,0,0,0,0
250010112004,594,569,4,0,5,0,9,7,591,567,3,0,5,0,9,7,3,2,1,0,0,0,0,0
250010113001,639,628,0,2,1,5,1,2,635,625,0,2,1,5,0,2,4,3,0,0,0,0,1,0
250010113002,1220,1176,12,6,4,0,8,14,1194,1160,11,6,4,0,6,7,26,16,1,0,0,0,2,7
250010113003,741,714,7,0,3,3,7,7,732,708,7,0,3,1,6,7,9,6,0,0,0,2,1,0
250010114001,792,777,4,0,2,0,4,5,786,772,4,0,2,0,3,5,6,5,0,0,0,0,1,0
250010114002,1101,1048,13,5,6,0,5,24,1077,1035,9,5,6,0,0,22,24,13,4,0,0,0,5,2
250010114003,429,419,1,0,0,0,4,5,418,413,1,0,0,0,1,3,11,6,0,0,0,0,3,2
250010114004,669,623,20,2,1,1,8,14,633,605,18,1,1,0,0,8,36,18,2,1,0,1,8,6
250010115001,676,646,7,4,2,0,13,4,665,641,5,4,2,0,10,3,11,5,2,0,0,0,3,1
250010115002,1080,980,24,3,10,2,16,45,1064,975,19,3,10,2,16,39,16,5,5,0,0,0,0,6
250010115003,612,584,11,4,1,0,3,9,603,580,11,0,1,0,2,9,9,4,0,4,0,0,1,0
250010115004,867,812,21,1,8,0,12,13,849,805,20,1,8,0,6,9,18,7,1,0,0,0,6,4
250010115005,794,722,35,10,8,0,11,8,762,700,33,5,8,0,9,7,32,22,2,5,0,0,2,1
250010116001,1513,1303,92,9,8,0,36,65,1478,1280,92,9,8,0,30,59,35,23,0,0,0,0,6,6
250010116002,615,549,21,6,3,0,22,14,584,538,16,3,3,0,12,12,31,11,5,3,0,0,10,2
250010116003,582,539,13,5,0,0,10,15,580,537,13,5,0,0,10,15,2,2,0,0,0,0,0,0
250010117001,639,617,6,1,2,0,4,9,621,606,5,1,2,0,2,5,18,11,1,0,0,0,2,4
250010117002,491,459,7,0,9,1,12,3,489,459,7,0,9,1,10,3,2,0,0,0,0,0,2,0
250010117003,747,693,8,11,13,0,8,14,731,678,8,11,13,0,8,13,16,15,0,0,0,0,0,1
250010118011,1480,1455,1,4,13,1,0,6,1469,1444,1,4,13,1,0,6,11,11,0,0,0,0,0,0
250010118012,923,903,7,3,4,0,2,4,915,895,7,3,4,0,2,4,8,8,0,0,0,0,0,0
250010118021,834,809,2,5,5,0,5,8,826,805,2,5,5,0,2,7,8,4,0,0,0,0,3,1
250010118022,844,796,7,0,12,0,6,23,834,791,6,0,12,0,2,23,10,5,1,0,0,0,4,0
250010118023,1439,1375,18,3,13,0,14,16,1418,1363,18,1,13,0,9,14,21,12,0,2,0,0,5,2
250010118024,1138,1086,11,1,9,0,16,15,1120,1075,10,1,9,0,13,12,18,11,1,0,0,0,3,3
250010120011,1583,1528,8,8,11,0,11,17,1560,1516,7,8,11,0,7,11,23,12,1,0,0,0,4,6
250010120012,1505,1404,76,0,0,0,10,15,1470,1377,75,0,0,0,4,14,35,27,1,0,0,0,6,1
250010120013,1259,1124,31,0,36,0,41,27,1218,1108,28,0,36,0,24,22,41,16,3,0,0,0,17,5
250010120014,1385,1315,16,2,7,0,21,24,1361,1304,9,2,7,0,16,23,24,11,7,0,0,0,5,1
250010120021,1200,1057,38,7,28,0,28,42,1132,1020,31,0,28,0,19,34,68,37,7,7,0,0,9,8
250010120022,1112,1018,21,3,26,0,16,28,1079,1000,21,3,24,0,10,21,33,18,0,0,2,0,6,7
250010120023,695,601,26,4,21,0,21,22,675,591,26,4,21,0,14,19,20,10,0,0,0,0,7,3
250010121011,1621,1496,35,11,24,1,28,26,1579,1477,33,10,24,1,16,18,42,19,2,1,0,0,12,8
250010121012,1047,917,35,3,13,0,33,46,1002,892,34,3,12,0,21,40,45,25,1,0,1,0,12,6
250010121013,874,839,7,4,0,0,15,9,856,829,7,4,0,0,9,7,18,10,0,0,0,0,6,2
250010121014,764,636,48,5,0,0,39,36,717,621,41,5,0,0,21,29,47,15,7,0,0,0,18,7
250010121015,1033,902,19,2,6,0,56,48,998,894,19,2,6,0,35,42,35,8,0,0,0,0,21,6
250010121021,811,739,23,2,12,1,11,23,782,719,20,2,11,1,8,21,29,20,3,0,1,0,3,2
250010121022,683,644,8,1,2,0,12,16,658,624,7,0,2,0,9,16,25,20,1,1,0,0,3,0
250010121023,698,629,18,0,7,0,27,17,678,611,18,0,7,0,25,17,20,18,0,0,0,0,2,0
250010121024,865,758,31,4,13,0,26,33,825,742,28,2,13,0,15,25,40,16,3,2,0,0,11,8
250010122001,1369,1338,10,1,6,0,2,12,1363,1335,10,0,6,0,0,12,6,3,0,1,0,0,2,0
250010122002,836,809,4,0,10,0,1,12,828,801,4,0,10,0,1,12,8,8,0,0,0,0,0,0
250010122003,2257,2141,18,8,30,3,15,42,2231,2130,18,8,30,1,8,36,26,11,0,0,0,2,7,6
250010122004,584,564,6,1,8,0,2,3,581,563,6,1,8,0,1,2,3,1,0,0,0,0,1,1
250010125021,638,595,18,4,4,0,8,9,628,590,18,4,3,0,5,8,10,5,0,0,1,0,3,1
250010125022,826,693,51,8,5,0,35,34,796,670,48,8,5,0,32,33,30,23,3,0,0,0,3,1
250010125023,885,735,27,10,24,0,63,26,831,710,24,10,24,0,40,23,54,25,3,0,0,0,23,3
250010125024,731,606,31,2,16,1,46,29,691,577,29,2,16,1,40,26,40,29,2,0,0,0,6,3
250010126011,1865,1609,60,5,69,7,52,63,1766,1535,55,5,69,6,35,61,99,74,5,0,0,1,17,2
250010126012,1012,835,64,15,10,1,42,45,963,805,61,11,9,1,32,44,49,30,3,4,1,0,10,1
250010126021,1298,1004,90,20,19,0,82,83,1221,964,86,19,19,0,53,80,77,40,4,1,0,0,29,3
250010126022,1403,1011,117,14,16,0,141,104,1245,924,111,13,16,0,87,94,158,87,6,1,0,0,54,10
250010126023,1221,878,120,27,19,0,72,105,1116,821,119,21,19,0,44,92,105,57,1,6,0,0,28,13
250010126024,993,752,94,21,22,1,39,64,923,700,91,19,22,0,30,61,70,52,3,2,0,1,9,3
250010127001,1398,1273,30,11,24,0,32,28,1382,1259,30,11,24,0,30,28,16,14,0,0,0,0,2,0
250010127002,1015,938,29,0,6,1,23,18,984,923,28,0,6,0,12,15,31,15,1,0,0,1,11,3
250010127003,760,739,3,7,5,0,2,4,739,721,3,4,5,0,2,4,21,18,0,3,0,0,0,0
250010127004,1389,1238,29,7,18,0,54,43,1344,1208,25,7,18,0,44,42,45,30,4,0,0,0,10,1
250010128001,911,866,10,1,6,0,8,20,894,857,10,0,6,0,3,18,17,9,0,1,0,0,5,2
250010128002,1139,1056,23,0,18,1,16,25,1116,1038,23,0,18,1,14,22,23,18,0,0,0,0,2,3
250010128003,1873,1761,29,0,12,0,29,42,1841,1743,26,0,12,0,27,33,32,18,3,0,0,0,2,9
250010129001,1117,1014,12,8,7,0,38,38,1089,1001,11,6,7,0,33,31,28,13,1,2,0,0,5,7
250010129002,1395,1289,26,4,25,5,37,9,1371,1280,25,4,25,5,23,9,24,9,1,0,0,0,14,0
250010129003,1623,1539,25,1,13,0,14,31,1603,1523,25,1,13,0,14,27,20,16,0,0,0,0,0,4
250010130021,506,486,5,0,8,0,0,7,503,483,5,0,8,0,0,7,3,3,0,0,0,0,0,0
250010130022,494,483,1,1,3,0,3,3,489,478,1,1,3,0,3,3,5,5,0,0,0,0,0,0
250010130023,870,816,10,1,2,0,12,29,854,812,8,1,2,0,8,23,16,4,2,0,0,0,4,6
250010130024,1029,975,9,2,6,0,16,21,1017,965,9,2,6,0,15,20,12,10,0,0,0,0,1,1
250010131001,1236,1173,12,4,13,0,5,29,1219,1159,12,3,13,0,4,28,17,14,0,1,0,0,1,1
250010131002,2292,2144,39,13,18,0,25,53,2239,2106,36,11,18,0,18,50,53,38,3,2,0,0,7,3
250010131003,685,668,1,3,4,0,2,7,684,668,1,3,4,0,2,6,1,0,0,0,0,0,0,1
250010131004,1722,1626,19,16,14,1,12,34,1677,1596,16,16,14,1,5,29,45,30,3,0,0,0,7,5
250010132001,1152,1131,10,0,4,0,2,5,1145,1124,10,0,4,0,2,5,7,7,0,0,0,0,0,0
250010132002,2474,2310,36,20,17,0,27,64,2408,2270,32,19,17,0,20,50,66,40,4,1,0,0,7,14
250010132003,1157,1128,11,1,4,0,4,9,1142,1119,9,1,4,0,1,8,15,9,2,0,0,0,3,1
250010133001,882,857,5,1,9,0,5,5,877,853,5,1,9,0,4,5,5,4,0,0,0,0,1,0
250010133002,961,930,4,0,13,4,1,9,952,922,3,0,13,4,1,9,9,8,1,0,0,0,0,0
250010133003,1375,1340,3,0,20,0,10,2,1361,1332,2,0,20,0,5,2,14,8,1,0,0,0,5,0
250010134001,822,812,2,2,1,0,0,5,815,805,2,2,1,0,0,5,7,7,0,0,0,0,0,0
250010134002,791,783,0,0,4,0,0,4,787,780,0,0,4,0,0,3,4,3,0,0,0,0,0,1
250010134003,1707,1658,6,2,20,0,1,20,1678,1642,6,1,20,0,0,9,29,16,0,1,0,0,1,11
250010134004,843,825,1,0,3,0,4,10,839,824,1,0,3,0,4,7,4,1,0,0,0,0,0,3
250010135001,1752,1709,9,1,23,0,5,5,1738,1697,8,1,23,0,4,5,14,12,1,0,0,0,1,0
250010135002,1321,1276,2,8,16,0,1,18,1308,1270,2,3,16,0,1,16,13,6,0,5,0,0,0,2
250010135003,2839,2720,6,9,37,0,18,49,2796,2696,5,9,36,0,7,43,43,24,1,0,1,0,11,6
250010135004,1028,991,4,0,24,0,1,8,1017,982,4,0,24,0,0,7,11,9,0,0,0,0,1,1
250010136001,2828,2720,9,5,27,1,18,48,2777,2687,9,5,27,1,3,45,51,33,0,0,0,0,15,3
250010136002,2389,2280,26,18,34,0,10,21,2341,2248,22,17,33,0,5,16,48,32,4,1,1,0,5,5
250010136003,1117,1078,1,5,15,0,3,15,1096,1062,1,5,15,0,0,13,21,16,0,0,0,0,3,2
250010137001,1411,1320,11,11,4,1,19,45,1381,1306,11,11,4,1,11,37,30,14,0,0,0,0,8,8
250010137002,772,728,8,2,5,0,8,21,766,722,8,2,5,0,8,21,6,6,0,0,0,0,0,0
250010137003,988,933,10,0,14,0,10,21,979,925,10,0,14,0,10,20,9,8,0,0,0,0,0,1
250010137004,1740,1637,17,17,22,0,18,29,1705,1616,17,16,22,0,6,28,35,21,0,1,0,0,12,1
250010138001,2538,2371,25,14,48,0,31,49,2483,2347,22,14,47,0,12,41,55,24,3,0,1,0,19,8
250010138002,1341,1294,5,3,15,1,5,18,1325,1284,5,3,15,0,3,15,16,10,0,0,0,1,2,3
250010138003,961,863,25,6,16,1,12,38,937,844,25,5,16,0,9,38,24,19,0,1,0,1,3,0
250010139001,556,536,7,3,3,0,0,7,555,536,7,2,3,0,0,7,1,0,0,1,0,0,0,0
250010139002,1371,1306,13,8,11,0,10,23,1366,1303,11,8,11,0,10,23,5,3,2,0,0,0,0,0
250010139003,1766,1671,12,5,16,4,14,44,1745,1660,11,2,16,4,12,40,21,11,1,3,0,0,2,4
250010139004,1138,1042,7,13,34,0,10,32,1125,1034,7,13,34,0,9,28,13,8,0,0,0,0,1,4
250010140021,938,929,1,0,2,0,4,2,929,920,1,0,2,0,4,2,9,9,0,0,0,0,0,0
250010140022,1748,1622,41,9,20,1,10,45,1727,1605,40,8,20,1,9,44,21,17,1,1,0,0,1,1
250010140023,751,708,18,5,10,0,3,7,743,703,15,5,10,0,3,7,8,5,3,0,0,0,0,0
250010140024,616,569,4,0,2,0,18,23,606,567,4,0,2,0,15,18,10,2,0,0,0,0,3,5
250010141001,1141,958,96,10,12,0,36,29,1047,908,93,9,11,0,5,21,94,50,3,1,1,0,31,8
250010143001,747,719,9,0,6,0,1,12,744,716,9,0,6,0,1,12,3,3,0,0,0,0,0,0
250010143002,864,812,14,3,11,0,12,12,853,805,14,3,11,0,11,9,11,7,0,0,0,0,1,3
250010143003,603,580,5,6,6,0,6,0,590,570,5,5,6,0,4,0,13,10,0,1,0,0,2,0
250010143004,1075,1026,6,0,12,1,9,21,1068,1022,6,0,12,1,7,20,7,4,0,0,0,0,2,1
250010143005,1095,1067,5,4,6,0,2,11,1079,1053,4,4,6,0,1,11,16,14,1,0,0,0,1,0
250010144021,2180,1944,54,14,29,6,61,72,2139,1914,54,14,29,6,55,67,41,30,0,0,0,0,6,5
250010144022,2199,2079,18,7,34,0,18,43,2173,2061,18,7,34,0,14,39,26,18,0,0,0,0,4,4
250010144023,2568,2349,69,14,19,1,36,80,2512,2312,67,12,19,1,24,77,56,37,2,2,0,0,12,3
250010145001,1624,1447,36,23,7,0,55,56,1586,1427,34,19,7,0,48,51,38,20,2,4,0,0,7,5
250010145002,2409,2201,53,13,15,0,39,88,2349,2173,52,11,15,0,21,77,60,28,1,2,0,0,18,11
250010145003,1362,1230,16,5,16,0,29,66,1321,1210,15,4,16,0,16,60,41,20,1,1,0,0,13,6
250010146001,1078,948,38,8,24,2,16,42,1052,942,35,5,24,2,14,30,26,6,3,3,0,0,2,12
250010146002,1279,1070,44,15,21,0,44,85,1243,1046,42,14,21,0,39,81,36,24,2,1,0,0,5,4
250010146003,551,506,13,9,6,0,4,13,550,506,13,9,6,0,4,12,1,0,0,0,0,0,0,1
250010146004,1222,1165,26,4,6,1,4,16,1196,1142,25,3,6,1,4,15,26,23,1,1,0,0,0,1
250010147001,672,636,6,1,15,0,4,10,662,626,6,1,15,0,4,10,10,10,0,0,0,0,0,0
250010147002,1211,1137,17,6,20,0,14,17,1198,1127,16,5,20,0,14,16,13,10,1,1,0,0,0,1
250010147003,1807,1605,44,23,16,0,50,69,1768,1573,44,20,16,0,48,67,39,32,0,3,0,0,2,2
250010148001,831,773,13,6,14,0,10,15,822,767,12,5,14,0,10,14,9,6,1,1,0,0,0,1
250010148002,716,686,6,3,6,0,3,12,709,681,6,3,6,0,2,11,7,5,0,0,0,0,1,1
250010148003,1124,991,40,6,27,0,29,31,1111,982,39,6,27,0,26,31,13,9,1,0,0,0,3,0
250010148004,716,638,13,7,14,0,27,17,700,629,13,7,12,0,25,14,16,9,0,0,2,0,2,3
250010149001,510,472,10,0,17,0,8,3,498,464,10,0,17,0,4,3,12,8,0,0,0,0,4,0
250010149002,896,853,5,0,22,0,4,12,879,842,5,0,20,0,1,11,17,11,0,0,2,0,3,1
250010149003,843,783,9,0,17,0,11,23,832,773,8,0,17,0,11,23,11,10,1,0,0,0,0,0
250010149004,1349,1262,25,6,23,1,0,32,1332,1249,24,6,23,1,0,29,17,13,1,0,0,0,0,3
250010150011,2174,1935,39,86,22,6,35,51,2107,1892,38,82,20,6,24,45,67,43,1,4,2,0,11,6
250010150012,2243,1944,43,105,22,0,31,98,2183,1903,42,99,22,0,28,89,60,41,1,6,0,0,3,9
250010150021,2516,2222,86,59,19,0,28,102,2462,2181,82,53,19,0,26,101,54,41,4,6,0,0,2,1
250010150022,1197,922,51,108,40,3,27,46,1170,909,51,104,40,3,23,40,27,13,0,4,0,0,4,6
250010151001,1858,1672,46,43,24,0,25,48,1813,1654,44,37,24,0,11,43,45,18,2,6,0,0,14,5
250010151002,1951,1794,33,20,28,0,24,52,1912,1766,33,19,28,0,16,50,39,28,0,1,0,0,8,2
250010152001,1150,1114,15,7,5,0,2,7,1142,1106,15,7,5,0,2,7,8,8,0,0,0,0,0,0
250010152002,915,879,7,4,11,0,6,8,900,868,7,4,10,0,3,8,15,11,0,0,1,0,3,0
250010153001,520,341,55,6,1,5,77,35,469,319,54,6,1,2,57,30,51,22,1,0,0,3,20,5
250010153002,1263,982,97,4,45,0,76,59,1216,956,93,4,45,0,64,54,47,26,4,0,0,0,12,5
250010153003,1255,810,135,34,31,1,103,141,1167,779,119,34,31,0,83,121,88,31,16,0,0,1,20,20
250019900000,0,0,0,0,0,0,0,0,0,0,0,0,0,0,0,0,0,0,0,0,0,0,0,0
250039001001,990,774,109,7,18,0,32,50,892,729,95,4,18,0,5,41,98,45,14,3,0,0,27,9
250039001002,1130,862,127,4,31,0,45,61,1036,834,123,3,31,0,1,44,94,28,4,1,0,0,44,17
250039001003,435,396,12,1,9,0,10,7,406,379,12,0,9,0,0,6,29,17,0,1,0,0,10,1
250039001004,834,636,77,5,10,0,59,47,739,601,76,3,10,0,10,39,95,35,1,2,0,0,49,8
250039002001,718,603,53,11,1,0,16,34,616,533,45,11,1,0,1,25,102,70,8,0,0,0,15,9
250039002002,676,546,42,1,15,1,24,47,607,519,40,0,15,0,5,28,69,27,2,1,0,1,19,19
250039002003,932,750,89,2,1,0,43,47,844,715,80,2,1,0,4,42,88,35,9,0,0,0,39,5
250039002004,608,461,51,1,20,0,31,44,509,407,42,0,20,0,5,35,99,54,9,1,0,0,26,9
250039002005,872,713,57,1,17,0,40,44,776,666,55,1,17,0,4,33,96,47,2,0,0,0,36,11
250039002006,643,488,63,3,15,0,35,39,555,445,60,3,15,0,1,31,88,43,3,0,0,0,34,8
250039003001,1053,942,44,1,13,0,17,36,1002,921,35,1,13,0,2,30,51,21,9,0,0,0,15,6
250039003002,808,688,35,1,2,3,43,36,735,660,35,1,2,1,4,32,73,28,0,0,0,2,39,4
250039003003,1042,958,30,1,25,0,12,16,996,928,30,1,25,0,0,12,46,30,0,0,0,0,12,4
250039004001,1213,1131,33,0,20,0,9,20,1190,1114,33,0,20,0,4,19,23,17,0,0,0,0,5,1
250039004002,1190,992,95,1,2,0,57,43,1075,944,87,1,2,0,4,37,115,48,8,0,0,0,53,6
250039004003,689,643,19,1,0,0,5,21,676,637,17,1,0,0,2,19,13,6,2,0,0,0,3,2
250039004004,1250,1197,27,0,5,0,5,16,1238,1189,27,0,5,0,1,16,12,8,0,0,0,0,4,0
250039004005,520,402,59,1,4,0,12,42,468,379,52,0,4,0,1,32,52,23,7,1,0,0,11,10
250039005001,1207,1148,25,0,16,0,3,15,1173,1122,24,0,16,0,2,9,34,26,1,0,0,0,1,6
250039005002,2081,1978,44,0,29,1,11,18,2023,1934,38,0,29,1,4,17,58,44,6,0,0,0,7,1
250039006001,624,567,33,0,2,0,10,12,605,557,33,0,2,0,1,12,19,10,0,0,0,0,9,0
250039006002,786,494,194,2,9,0,25,62,704,459,176,2,9,0,5,53,82,35,18,0,0,0,20,9
250039006003,651,475,94,6,16,0,14,46,625,466,94,6,16,0,4,39,26,9,0,0,0,0,10,7
250039006004,1134,858,150,5,8,1,32,80,1062,828,146,3,8,1,9,67,72,30,4,2,0,0,23,13
250039006005,922,643,164,4,17,0,40,54,817,602,143,4,17,0,10,41,105,41,21,0,0,0,30,13
250039007001,658,611,20,0,4,0,7,16,636,597,20,0,4,0,0,15,22,14,0,0,0,0,7,1
250039007002,641,605,20,0,3,0,6,7,626,597,20,0,3,0,0,6,15,8,0,0,0,0,6,1
250039007003,729,697,7,1,4,0,5,15,710,687,7,1,4,0,0,11,19,10,0,0,0,0,5,4
250039007004,882,861,11,0,3,0,1,6,869,850,11,0,3,0,0,5,13,11,0,0,0,0,1,1
250039008001,1057,1020,5,1,17,0,8,6,1044,1014,5,1,17,0,2,5,13,6,0,0,0,0,6,1
250039008002,640,594,7,1,19,0,8,11,624,589,7,1,19,0,2,6,16,5,0,0,0,0,6,5
250039008003,814,795,4,0,3,0,2,10,809,790,4,0,3,0,2,10,5,5,0,0,0,0,0,0
250039008004,1538,1456,24,0,12,0,12,34,1506,1441,24,0,12,0,0,29,32,15,0,0,0,0,12,5
250039008005,786,752,5,0,12,0,4,13,780,748,5,0,12,0,2,13,6,4,0,0,0,0,2,0
250039009001,799,767,13,1,1,0,3,14,781,749,13,1,1,0,3,14,18,18,0,0,0,0,0,0
250039009002,1033,830,72,5,8,0,60,58,930,801,65,5,8,0,0,51,103,29,7,0,0,0,60,7
250039009003,985,852,48,8,17,0,31,29,914,816,45,8,17,0,0,28,71,36,3,0,0,0,31,1
250039009004,1678,1573,29,2,12,0,30,32,1611,1539,24,1,12,0,6,29,67,34,5,1,0,0,24,3
250039009005,639,584,23,1,4,0,12,15,618,572,23,1,4,0,3,15,21,12,0,0,0,0,9,0
250039011001,470,447,8,0,12,0,1,2,467,445,8,0,12,0,0,2,3,2,0,0,0,0,1,0
250039011002,658,612,13,0,15,0,6,12,636,598,13,0,15,0,0,10,22,14,0,0,0,0,6,2
250039011003,877,833,6,0,20,0,1,17,872,829,6,0,20,0,0,17,5,4,0,0,0,0,1,0
250039011004,1724,1536,119,5,27,0,15,22,1682,1514,114,5,27,0,1,21,42,22,5,0,0,0,14,1
250039111001,1375,1336,18,0,11,0,1,9,1355,1321,15,0,11,0,0,8,20,15,3,0,0,0,1,1
250039111002,930,901,10,0,8,0,0,11,920,892,9,0,8,0,0,11,10,9,1,0,0,0,0,0
250039111003,786,758,15,1,1,1,4,6,775,750,15,1,1,1,1,6,11,8,0,0,0,0,3,0
250039121001,1112,1088,0,2,15,0,0,7,1097,1073,0,2,15,0,0,7,15,15,0,0,0,0,0,0
250039121002,933,889,9,0,9,0,13,13,913,882,9,0,9,0,0,13,20,7,0,0,0,0,13,0
250039121003,605,575,2,0,8,0,8,12,596,574,2,0,8,0,3,9,9,1,0,0,0,0,5,3
250039121004,931,910,8,0,1,0,3,9,916,898,8,0,1,0,0,9,15,12,0,0,0,0,3,0
250039121005,603,590,3,1,3,0,0,6,598,586,2,1,3,0,0,6,5,4,1,0,0,0,0,0
250039121006,1292,1251,22,1,9,1,4,4,1273,1236,22,1,9,1,0,4,19,15,0,0,0,0,4,0
250039121007,1280,1235,5,0,8,0,9,23,1254,1220,5,0,8,0,1,20,26,15,0,0,0,0,8,3
250039131001,644,607,1,1,17,0,0,18,635,600,1,1,17,0,0,16,9,7,0,0,0,0,0,2
250039131002,649,592,21,3,2,0,21,10,606,566,18,2,2,0,8,10,43,26,3,1,0,0,13,0
250039131003,823,785,11,0,16,0,0,11,816,779,11,0,16,0,0,10,7,6,0,0,0,0,0,1
250039131004,480,474,1,0,2,0,0,3,476,470,1,0,2,0,0,3,4,4,0,0,0,0,0,0
250039131005,1128,1079,5,2,8,2,13,19,1090,1059,5,0,8,2,1,15,38,20,0,2,0,0,12,4
250039131006,584,541,19,0,4,0,8,12,566,524,19,0,4,0,7,12,18,17,0,0,0,0,1,0
250039131007,717,688,0,1,20,0,4,4,698,673,0,1,20,0,1,3,19,15,0,0,0,0,3,1
250039141001,1155,1081,17,2,17,1,27,10,1115,1062,16,1,17,0,14,5,40,19,1,1,0,1,13,5
250039141002,994,928,13,0,20,0,18,15,923,882,12,0,20,0,1,8,71,46,1,0,0,0,17,7
250039141003,1057,981,7,4,21,0,29,15,981,936,6,4,21,0,7,7,76,45,1,0,0,0,22,8
250039141004,1140,1104,8,0,14,0,5,9,1106,1079,7,0,14,0,0,6,34,25,1,0,0,0,5,3
250039141005,1117,1070,15,1,14,0,7,10,1098,1058,15,1,14,0,0,10,19,12,0,0,0,0,7,0
250039141006,480,445,1,4,14,0,12,4,459,436,1,4,14,0,1,3,21,9,0,0,0,0,11,1
250039201011,636,601,5,1,21,0,1,7,626,593,4,0,21,0,1,7,10,8,1,1,0,0,0,0
250039201012,1390,1282,9,3,30,0,22,44,1344,1261,9,3,30,0,4,37,46,21,0,0,0,0,18,7
250039201013,1751,1369,109,1,169,2,20,81,1634,1293,103,0,169,1,2,66,117,76,6,1,0,1,18,15
250039201014,861,805,13,1,21,2,2,17,836,786,12,1,21,0,0,16,25,19,1,0,0,2,2,1
250039201021,1005,753,62,0,106,0,15,69,925,710,58,0,104,0,0,53,80,43,4,0,2,0,15,16
250039201022,1065,991,19,0,30,0,8,17,1044,976,19,0,30,0,5,14,21,15,0,0,0,0,3,3
250039201023,1046,981,7,2,23,0,9,24,1025,968,7,2,23,0,4,21,21,13,0,0,0,0,5,3
250039213001,1239,1164,21,3,11,3,5,32,1215,1150,20,3,11,3,0,28,24,14,1,0,0,0,5,4
250039213002,2307,2125,74,6,21,1,24,56,2214,2073,64,5,20,1,1,50,93,52,10,1,1,0,23,6
250039213003,680,631,15,4,7,0,2,21,657,614,15,4,7,0,0,17,23,17,0,0,0,0,2,4
250039213004,892,780,50,4,2,2,28,26,840,761,43,3,2,2,5,24,52,19,7,1,0,0,23,2
250039214001,780,739,13,1,0,1,5,21,752,721,11,1,0,1,0,18,28,18,2,0,0,0,5,3
250039214002,919,836,20,3,3,1,23,33,853,809,17,3,3,1,0,20,66,27,3,0,0,0,23,13
250039215001,979,940,3,4,10,0,11,11,965,937,3,4,10,0,2,9,14,3,0,0,0,0,9,2
250039215002,2121,1960,42,4,21,0,26,68,2055,1925,42,4,19,0,2,63,66,35,0,0,2,0,24,5
250039221001,699,689,0,0,0,0,0,10,692,683,0,0,0,0,0,9,7,6,0,0,0,0,0,1
250039221002,720,705,7,0,2,0,1,5,705,693,6,0,2,0,0,4,15,12,1,0,0,0,1,1
250039221003,680,645,5,0,7,0,1,22,674,643,4,0,7,0,1,19,6,2,1,0,0,0,0,3
250039221004,581,560,2,0,10,1,0,8,580,560,2,0,9,1,0,8,1,0,0,0,1,0,0,0
250039222001,554,539,3,3,1,0,7,1,540,532,3,3,1,0,0,1,14,7,0,0,0,0,7,0
250039222002,815,799,6,0,2,0,0,8,809,794,6,0,2,0,0,7,6,5,0,0,0,0,0,1
250039222003,1305,1249,10,9,9,0,2,26,1289,1243,9,2,9,0,0,26,16,6,1,7,0,0,2,0
250039222004,1015,981,9,3,2,0,5,15,1006,973,9,3,2,0,4,15,9,8,0,0,0,0,1,0
250039223001,963,933,7,0,3,1,3,16,956,930,7,0,2,1,0,16,7,3,0,0,1,0,3,0
250039223002,1153,1126,7,0,6,0,0,14,1136,1115,5,0,6,0,0,10,17,11,2,0,0,0,0,4
250039231001,874,851,4,2,5,0,2,10,872,850,4,2,5,0,1,10,2,1,0,0,0,0,1,0
250039231002,1104,1072,11,2,3,0,0,16,1087,1056,10,2,3,0,0,16,17,16,1,0,0,0,0,0
250039231003,1257,1244,0,1,4,0,5,3,1241,1233,0,1,4,0,0,3,16,11,0,0,0,0,5,0
250039241001,614,596,2,0,4,0,6,6,599,582,2,0,4,0,5,6,15,14,0,0,0,0,1,0
250039241002,779,731,15,1,13,0,9,10,737,696,15,1,13,0,3,9,42,35,0,0,0,0,6,1
250039241003,554,549,1,0,2,0,1,1,552,548,1,0,2,0,0,1,2,1,0,0,0,0,1,0
250039251001,558,528,2,0,3,0,4,21,525,512,2,0,3,0,0,8,33,16,0,0,0,0,4,13
250056406003,1478,1271,84,4,40,0,36,43,1375,1223,58,4,36,0,21,33,103,48,26,0,4,0,15,10
250056406004,1010,871,29,4,50,0,33,23,955,859,29,0,50,0,2,15,55,12,0,4,0,0,31,8
250056407001,1526,1377,24,2,60,3,37,23,1489,1370,23,2,60,0,12,22,37,7,1,0,0,3,25,1
250056407002,764,715,14,0,29,0,5,1,751,706,12,0,29,0,3,1,13,9,2,0,0,0,2,0
250056407003,610,574,12,0,14,0,4,6,600,565,12,0,14,0,4,5,10,9,0,0,0,0,0,1
250056408001,1230,851,98,7,66,0,129,79,985,760,80,3,66,0,27,49,245,91,18,4,0,0,102,30
250056408002,1222,1013,63,3,77,2,27,37,1131,963,57,3,72,0,9,27,91,50,6,0,5,2,18,10
250056408003,1361,1205,33,1,60,0,39,23,1275,1158,27,1,60,0,6,23,86,47,6,0,0,0,33,0
250056409011,500,452,12,0,1,0,29,6,464,442,12,0,1,0,7,2,36,10,0,0,0,0,22,4
250056409012,1471,1241,82,2,12,0,72,62,1367,1199,73,1,12,0,27,55,104,42,9,1,0,0,45,7
250056409013,1240,871,122,11,16,0,142,78,1028,809,111,5,16,0,29,58,212,62,11,6,0,0,113,20
250056409014,1249,1040,73,1,26,0,74,35,1131,995,66,0,25,0,14,31,118,45,7,1,1,0,60,4
250056409015,611,528,18,0,7,0,39,19,538,497,11,0,7,0,4,19,73,31,7,0,0,0,35,0
250056410001,780,663,46,1,1,0,42,27,713,634,41,1,1,0,14,22,67,29,5,0,0,0,28,5
250056410002,827,712,39,1,1,0,52,22,741,672,35,1,1,0,12,20,86,40,4,0,0,0,40,2
250056410003,812,694,32,0,23,0,26,37,752,662,26,0,23,0,7,34,60,32,6,0,0,0,19,3
250056411011,1095,814,103,11,31,0,97,39,933,768,87,4,31,0,13,30,162,46,16,7,0,0,84,9
250056411012,617,482,54,3,5,0,47,26,547,462,47,0,5,0,8,25,70,20,7,3,0,0,39,1
250056412001,1621,1289,77,1,65,0,109,80,1483,1223,63,1,65,0,67,64,138,66,14,0,0,0,42,16
250056412002,1182,998,77,1,47,0,37,22,1057,912,64,1,47,0,16,17,125,86,13,0,0,0,21,5
250056413001,836,447,93,20,71,9,144,52,496,313,70,13,71,2,4,23,340,134,23,7,0,7,140,29
250056413002,1221,1054,42,2,44,1,38,40,1157,1024,41,2,43,1,16,30,64,30,1,0,1,0,22,10
250056413003,978,709,65,12,44,0,117,31,819,647,63,8,44,0,28,29,159,62,2,4,0,0,89,2
250056413004,1244,999,81,3,67,0,52,42,1064,894,74,0,66,0,3,27,180,105,7,3,1,0,49,15
250056413005,1047,868,44,6,35,0,44,50,925,798,42,3,35,0,16,31,122,70,2,3,0,0,28,19
250056414001,575,371,46,3,112,0,35,8,507,328,43,3,112,0,16,5,68,43,3,0,0,0,19,3
250056414002,881,712,30,1,21,0,70,47,785,670,25,1,21,0,39,29,96,42,5,0,0,0,31,18
250056414003,1130,976,45,0,21,0,45,43,1041,933,43,0,18,0,17,30,89,43,2,0,3,0,28,13
250056415001,1337,1217,42,4,19,1,23,31,1286,1186,38,4,18,1,8,31,51,31,4,0,1,0,15,0
250056415002,1064,976,33,1,6,0,18,30,998,932,28,1,6,0,4,27,66,44,5,0,0,0,14,3
250056416001,1052,1025,5,2,7,0,1,12,1035,1011,5,0,7,0,1,11,17,14,0,2,0,0,0,1
250056416002,1271,1194,26,4,7,0,16,24,1245,1180,26,4,7,0,7,21,26,14,0,0,0,0,9,3
250056417001,609,598,2,0,5,0,0,4,609,598,2,0,5,0,0,4,0,0,0,0,0,0,0,0
250056417002,1267,1160,19,4,44,4,11,25,1205,1124,14,3,44,0,3,17,62,36,5,1,0,4,8,8
250056417003,1078,953,31,0,54,0,23,17,1035,931,26,0,54,0,8,16,43,22,5,0,0,0,15,1
250056417004,2142,2027,33,1,27,0,24,30,2103,2010,29,1,25,0,10,28,39,17,4,0,2,0,14,2
250056418001,1051,967,33,5,14,0,2,30,1019,939,31,5,14,0,0,30,32,28,2,0,0,0,2,0
250056418002,495,473,7,0,2,0,8,5,475,460,7,0,2,0,1,5,20,13,0,0,0,0,7,0
250056418003,513,465,21,2,8,0,6,11,484,448,16,0,8,0,3,9,29,17,5,2,0,0,3,2
250056419001,978,869,38,4,15,0,30,22,930,836,37,3,14,0,23,17,48,33,1,1,1,0,7,5
250056419002,1297,1140,66,9,11,0,28,43,1228,1097,63,6,11,0,10,41,69,43,3,3,0,0,18,2
250056420001,631,556,21,1,20,0,11,22,579,523,21,1,20,0,1,13,52,33,0,0,0,0,10,9
250056420002,882,804,36,0,15,0,17,10,830,768,34,0,15,0,5,8,52,36,2,0,0,0,12,2
250056420003,1761,1332,151,6,93,4,95,80,1492,1188,139,4,93,0,10,58,269,144,12,2,0,4,85,22
250056421001,2394,2083,128,7,58,1,61,56,2241,1989,114,3,58,1,33,43,153,94,14,4,0,0,28,13
250056421002,1172,1037,47,1,18,0,40,29,1072,990,39,1,18,0,3,21,100,47,8,0,0,0,37,8
250056421003,578,507,26,1,6,0,12,26,557,501,26,1,6,0,7,16,21,6,0,0,0,0,5,10
250056422001,1089,1010,36,0,8,0,11,24,1057,997,31,0,8,0,0,21,32,13,5,0,0,0,11,3
250056422002,1036,845,52,1,44,0,42,52,869,741,41,1,44,0,7,35,167,104,11,0,0,0,35,17
250056422003,990,938,21,0,1,0,6,24,973,930,20,0,1,0,4,18,17,8,1,0,0,0,2,6
250056422004,766,688,24,4,8,0,28,14,722,670,24,3,8,0,6,11,44,18,0,1,0,0,22,3
250056423001,1075,1025,5,4,23,0,8,10,1064,1014,5,4,23,0,8,10,11,11,0,0,0,0,0,0
250056423002,1120,1059,15,2,22,0,8,14,1096,1049,15,0,22,0,2,8,24,10,0,2,0,0,6,6
250056424001,992,861,43,3,40,2,13,30,939,835,35,2,40,2,0,25,53,26,8,1,0,0,13,5
250056424002,756,732,18,0,3,0,1,2,749,728,16,0,3,0,0,2,7,4,2,0,0,0,1,0
250056424003,1012,960,20,0,15,0,4,13,989,943,20,0,14,0,0,12,23,17,0,0,1,0,4,1
250056425001,1510,1441,41,0,14,0,3,11,1474,1408,41,0,14,0,1,10,36,33,0,0,0,0,2,1
250056425002,3007,2881,37,6,31,1,13,38,2953,2843,36,2,31,1,5,35,54,38,1,4,0,0,8,3
250056441011,1818,1754,13,0,27,0,5,19,1807,1745,12,0,27,0,5,18,11,9,1,0,0,0,0,1
250056441012,1498,1463,2,5,10,0,4,14,1478,1445,1,5,10,0,3,14,20,18,1,0,0,0,1,0
250056441013,2512,2448,13,3,18,0,4,26,2486,2428,13,3,18,0,1,23,26,20,0,0,0,0,3,3
250056441021,2590,2529,7,1,17,0,9,27,2565,2511,7,1,17,0,5,24,25,18,0,0,0,0,4,3
250056441022,2467,2387,4,2,16,1,11,46,2434,2367,4,2,16,1,5,39,33,20,0,0,0,0,6,7
250056442001,1300,1269,6,0,1,0,12,12,1274,1254,6,0,1,0,1,12,26,15,0,0,0,0,11,0
250056442002,908,892,8,0,1,0,2,5,898,883,8,0,1,0,1,5,10,9,0,0,0,0,1,0
250056442003,1975,1934,7,4,13,0,6,11,1956,1918,7,4,13,0,5,9,19,16,0,0,0,0,1,2
250056442004,1315,1287,2,5,19,0,1,1,1308,1281,2,5,19,0,0,1,7,6,0,0,0,0,1,0
250056442005,916,883,1,0,22,0,0,10,911,878,1,0,22,0,0,10,5,5,0,0,0,0,0,0
250056442006,866,854,5,0,4,0,0,3,857,845,5,0,4,0,0,3,9,9,0,0,0,0,0,0
250056451011,691,671,1,0,8,0,0,11,678,660,1,0,8,0,0,9,13,11,0,0,0,0,0,2
250056451012,2630,2580,8,2,10,0,2,28,2604,2561,7,1,10,0,1,24,26,19,1,1,0,0,1,4
250056451013,1542,1517,12,0,2,0,1,10,1538,1514,12,0,2,0,0,10,4,3,0,0,0,0,1,0
250056451021,3318,3187,26,4,44,0,10,47,3269,3146,22,2,43,0,9,47,49,41,4,2,1,0,1,0
250056451022,976,946,12,1,0,0,3,14,960,939,12,1,0,0,0,8,16,7,0,0,0,0,3,6
250056451023,1091,1055,8,1,7,0,1,19,1082,1047,8,1,7,0,1,18,9,8,0,0,0,0,0,1
250056451031,2162,2106,17,1,21,0,6,11,2145,2090,17,1,21,0,5,11,17,16,0,0,0,0,1,0
250056451032,2689,2621,14,3,12,1,12,26,2650,2584,13,2,12,1,12,26,39,37,1,1,0,0,0,0
250056451033,766,746,3,1,6,0,4,6,766,746,3,1,6,0,4,6,0,0,0,0,0,0,0,0
250056461011,1089,1064,7,0,9,0,3,6,1083,1058,7,0,9,0,3,6,6,6,0,0,0,0,0,0
250056461012,2549,2490,9,0,15,0,10,25,2519,2464,9,0,15,0,6,25,30,26,0,0,0,0,4,0
250056461013,1411,1384,7,0,4,0,9,7,1401,1374,7,0,4,0,9,7,10,10,0,0,0,0,0,0
250056461014,2307,2229,18,4,24,0,4,28,2286,2215,14,4,24,0,4,25,21,14,4,0,0,0,0,3
250056461031,2285,2248,5,0,14,1,0,17,2260,2226,4,0,14,1,0,15,25,22,1,0,0,0,0,2
250056461032,2020,1983,4,1,6,3,8,15,2004,1972,4,0,6,3,5,14,16,11,0,1,0,0,3,1
250056461033,1299,1265,10,0,7,0,5,12,1293,1260,10,0,7,0,4,12,6,5,0,0,0,0,1,0
250056461041,825,790,6,1,14,0,5,9,816,784,6,0,14,0,5,7,9,6,0,1,0,0,0,2
250056461042,1747,1717,6,1,10,0,1,12,1732,1703,6,1,10,0,0,12,15,14,0,0,0,0,1,0
250056501011,1936,1827,25,3,13,0,39,29,1894,1806,25,2,13,0,25,23,42,21,0,1,0,0,14,6
250056501012,1668,1559,31,1,6,0,30,41,1621,1527,29,1,6,0,23,35,47,32,2,0,0,0,7,6
250056501013,2149,1962,59,2,7,0,54,65,2056,1904,54,1,7,0,41,49,93,58,5,1,0,0,13,16
250056501021,1364,1012,55,10,18,0,220,49,1007,896,16,3,18,0,37,37,357,116,39,7,0,0,183,12
250056501022,2014,1776,53,5,32,0,79,69,1918,1723,51,4,31,0,47,62,96,53,2,1,1,0,32,7
250056501023,1501,1182,72,12,22,0,137,76,1263,1057,58,5,22,0,55,66,238,125,14,7,0,0,82,10
250056502011,1093,1033,23,3,11,0,8,15,1062,1010,22,3,11,0,5,11,31,23,1,0,0,0,3,4
250056502012,1067,974,15,3,23,0,31,21,1027,952,12,3,23,0,21,16,40,22,3,0,0,0,10,5
250056502013,756,670,24,2,12,0,29,19,698,630,16,2,12,0,21,17,58,40,8,0,0,0,8,2
250056502021,2142,1912,75,7,10,0,79,59,1969,1818,63,6,10,0,26,46,173,94,12,1,0,0,53,13
250056503001,715,651,24,0,13,0,9,18,683,627,24,0,13,0,3,16,32,24,0,0,0,0,6,2
250056503002,772,690,21,1,3,0,19,38,723,655,20,1,3,0,9,35,49,35,1,0,0,0,10,3
250056503003,1108,935,51,25,11,0,47,39,994,899,28,3,11,0,20,33,114,36,23,22,0,0,27,6
250056503004,709,678,5,1,2,0,20,3,683,668,5,1,2,0,5,2,26,10,0,0,0,0,15,1
250056504001,810,708,29,1,1,0,38,33,733,667,15,1,1,0,18,31,77,41,14,0,0,0,20,2
250056504002,1316,1151,40,4,3,0,64,54,1197,1090,34,4,3,0,23,43,119,61,6,0,0,0,41,11
250056504003,960,815,35,1,0,0,56,53,798,717,25,1,0,0,22,33,162,98,10,0,0,0,34,20
250056504004,687,609,19,2,10,1,22,24,633,573,19,0,10,0,10,21,54,36,0,2,0,1,12,3
250056505001,658,584,11,9,0,0,36,18,602,567,10,0,0,0,11,14,56,17,1,9,0,0,25,4
250056505002,1142,976,29,1,18,1,76,41,1029,938,23,0,18,1,14,35,113,38,6,1,0,0,62,6
250056505003,1341,1071,50,12,23,3,97,85,1165,1031,31,1,22,3,22,55,176,40,19,11,1,0,75,30
250056506001,1322,1011,69,47,14,0,121,60,1062,940,46,6,14,0,17,39,260,71,23,41,0,0,104,21
250056506002,767,516,60,5,10,0,129,47,583,464,48,0,10,0,31,30,184,52,12,5,0,0,98,17
250056506003,670,563,23,3,1,0,45,35,568,516,21,1,1,0,11,18,102,47,2,2,0,0,34,17
250056507001,1119,620,117,55,5,3,241,78,653,478,76,8,5,0,48,38,466,142,41,47,0,3,193,40
250056507002,1464,644,97,285,15,0,344,79,755,515,78,24,13,0,81,44,709,129,19,261,2,0,263,35
250056508001,970,778,51,11,5,2,85,38,878,754,46,1,5,2,35,35,92,24,5,10,0,0,50,3
250056508002,795,608,36,1,5,0,120,25,674,589,36,0,5,0,24,20,121,19,0,1,0,0,96,5
250056508003,935,498,54,41,15,5,253,69,575,427,50,11,15,0,41,31,360,71,4,30,0,5,212,38
250056508004,951,605,105,8,5,0,167,61,712,502,90,5,5,0,67,43,239,103,15,3,0,0,100,18
250056509001,799,419,68,19,22,0,204,67,401,280,34,3,21,0,37,26,398,139,34,16,1,0,167,41
250056509002,1151,867,66,5,18,0,147,48,979,798,51,5,18,0,62,45,172,69,15,0,0,0,85,3
250056509003,917,364,120,18,6,0,313,96,389,189,77,8,5,0,60,50,528,175,43,10,1,0,253,46
250056510011,2865,2383,91,19,77,3,178,114,2693,2297,87,14,77,3,123,92,172,86,4,5,0,0,55,22
250056510021,1970,1722,74,19,40,1,57,57,1905,1686,71,15,40,1,37,55,65,36,3,4,0,0,20,2
250056510022,1863,1132,188,12,24,1,340,166,1338,910,161,5,23,1,104,134,525,222,27,7,1,0,236,32
250056511001,1061,641,104,10,4,0,207,95,645,471,58,4,4,0,58,50,416,170,46,6,0,0,149,45
250056511002,1325,815,152,18,5,0,197,138,952,644,121,5,5,0,67,110,373,171,31,13,0,0,130,28
250056511003,923,669,77,1,15,0,101,60,836,641,68,1,15,0,66,45,87,28,9,0,0,0,35,15
250056511004,808,672,45,2,1,0,49,39,726,624,35,2,1,0,29,35,82,48,10,0,0,0,20,4
250056512001,733,397,74,58,2,8,151,43,500,324,69,24,2,0,45,36,233,73,5,34,0,8,106,7
250056512002,1335,870,123,40,14,0,223,65,996,802,87,9,14,0,30,54,339,68,36,31,0,0,193,11
250056513001,1161,743,104,14,19,0,195,86,891,646,77,11,19,0,76,62,270,97,27,3,0,0,119,24
250056513002,1066,713,110,12,17,1,130,83,901,672,75,6,17,1,63,67,165,41,35,6,0,0,67,16
250056514001,1168,858,122,9,12,1,81,85,1051,807,118,4,12,0,40,70,117,51,4,5,0,1,41,15
250056514002,737,493,65,0,2,0,113,64,639,462,55,0,1,0,67,54,98,31,10,0,1,0,46,10
250056514003,701,407,92,5,2,0,125,70,582,375,81,3,2,0,67,54,119,32,11,2,0,0,58,16
250056514004,609,307,119,9,0,1,96,77,501,262,99,7,0,1,61,71,108,45,20,2,0,0,35,6
250056515001,906,693,60,6,8,0,86,53,801,633,47,2,8,0,61,50,105,60,13,4,0,0,25,3
250056515002,604,344,91,1,13,0,103,52,511,301,83,0,11,0,70,46,93,43,8,1,2,0,33,6
250056515003,564,304,74,3,10,0,112,61,468,261,65,3,10,0,74,55,96,43,9,0,0,0,38,6
250056515004,1041,419,181,16,12,0,296,117,600,266,145,8,12,0,83,86,441,153,36,8,0,0,213,31
250056516001,780,378,128,15,17,0,154,88,655,335,117,12,17,0,93,81,125,43,11,3,0,0,61,7
250056516002,1011,599,116,7,20,0,169,100,878,559,104,7,20,0,100,88,133,40,12,0,0,0,69,12
250056516003,959,786,43,3,4,0,70,53,885,757,30,1,4,0,47,46,74,29,13,2,0,0,23,7
250056516004,1112,730,117,6,9,0,170,80,1013,696,112,6,9,0,129,61,99,34,5,0,0,0,41,19
250056517001,843,326,211,8,3,0,192,103,620,241,175,4,3,0,123,74,223,85,36,4,0,0,69,29
250059900000,0,0,0,0,0,0,0,0,0,0,0,0,0,0,0,0,0,0,0,0,0,0,0,0
250072001001,688,627,23,4,3,0,1,30,661,604,22,4,3,0,1,27,27,23,1,0,0,0,0,3
250072001002,1341,1152,54,11,6,0,62,56,1300,1128,52,11,6,0,55,48,41,24,2,0,0,0,7,8
250072001003,702,625,32,1,3,0,22,19,680,608,32,1,3,0,18,18,22,17,0,0,0,0,4,1
250072001004,924,732,30,1,10,0,116,35,903,729,30,0,9,0,110,25,21,3,0,1,1,0,6,10
250072001005,294,272,5,0,9,1,5,2,287,265,5,0,9,1,5,2,7,7,0,0,0,0,0,0
250072002001,637,524,49,5,7,0,16,36,618,512,47,5,7,0,15,32,19,12,2,0,0,0,1,4
250072002002,376,285,44,5,5,0,14,23,367,281,42,5,5,0,13,21,9,4,2,0,0,0,1,2
250072002003,1810,1565,57,16,28,4,70,70,1770,1541,55,14,28,0,64,68,40,24,2,2,0,4,6,2
250072002004,813,681,49,11,6,1,16,49,791,664,46,11,6,1,14,49,22,17,3,0,0,0,2,0
250072002005,891,753,21,7,6,0,62,42,871,739,19,6,6,0,61,40,20,14,2,1,0,0,1,2
250072003001,179,170,4,1,1,0,0,3,175,167,3,1,1,0,0,3,4,3,1,0,0,0,0,0
250072003002,392,379,6,0,0,2,3,2,388,378,6,0,0,0,2,2,4,1,0,0,0,2,1,0
250072003003,1294,1164,17,10,8,0,64,31,1264,1150,16,9,8,0,50,31,30,14,1,1,0,0,14,0
250072003004,2202,1878,75,9,14,1,157,68,2141,1855,60,7,10,1,141,67,61,23,15,2,4,0,16,1
250072004001,853,810,3,2,9,0,11,18,848,807,3,2,9,0,10,17,5,3,0,0,0,0,1,1
250072004002,1887,1789,22,15,10,1,14,36,1857,1771,20,15,10,1,6,34,30,18,2,0,0,0,8,2
250072004003,409,397,5,2,0,0,0,5,407,395,5,2,0,0,0,5,2,2,0,0,0,0,0,0
250072004004,457,438,10,0,2,0,3,4,452,435,10,0,2,0,1,4,5,3,0,0,0,0,2,0
250072004005,311,179,5,83,1,0,6,37,296,174,4,82,1,0,5,30,15,5,1,1,0,0,1,7
250072004006,75,72,0,0,0,0,0,3,75,72,0,0,0,0,0,3,0,0,0,0,0,0,0,0
250079900000,0,0,0,0,0,0,0,0,0,0,0,0,0,0,0,0,0,0,0,0,0,0,0,0
250092011001,629,609,3,0,9,0,6,2,622,606,2,0,9,0,3,2,7,3,1,0,0,0,3,0
250092011002,547,531,7,0,6,0,0,3,543,527,7,0,6,0,0,3,4,4,0,0,0,0,0,0
250092011003,907,889,1,2,13,0,0,2,902,884,1,2,13,0,0,2,5,5,0,0,0,0,0,0
250092011004,1327,1261,5,1,30,0,13,17,1291,1240,5,1,30,0,2,13,36,21,0,0,0,0,11,4
250092021011,681,668,4,0,6,0,0,3,669,656,4,0,6,0,0,3,12,12,0,0,0,0,0,0
250092021012,690,662,2,0,12,0,2,12,678,657,1,0,12,0,0,8,12,5,1,0,0,0,2,4
250092021013,692,638,9,1,6,0,17,21,670,631,9,1,6,0,5,18,22,7,0,0,0,0,12,3
250092021021,1195,1125,14,0,34,0,7,15,1169,1110,13,0,34,0,0,12,26,15,1,0,0,0,7,3
250092021022,1344,1245,22,1,38,0,12,26,1280,1198,20,1,38,0,3,20,64,47,2,0,0,0,9,6
250092021023,1863,1755,30,2,38,1,13,24,1815,1725,29,2,38,1,2,18,48,30,1,0,0,0,11,6
250092021024,793,718,24,1,14,0,17,19,754,705,23,1,14,0,3,8,39,13,1,0,0,0,14,11
250092021025,641,601,18,0,5,3,2,12,631,598,16,0,5,3,0,9,10,3,2,0,0,0,2,3
250092022001,839,809,1,0,16,0,1,12,826,799,1,0,16,0,0,10,13,10,0,0,0,0,1,2
250092022002,989,947,7,0,18,0,1,16,966,929,7,0,18,0,0,12,23,18,0,0,0,0,1,4
250092022003,759,742,3,2,11,0,0,1,758,741,3,2,11,0,0,1,1,1,0,0,0,0,0,0
250092022004,1532,1455,15,6,23,0,14,19,1488,1426,15,0,23,0,5,19,44,29,0,6,0,0,9,0
250092022005,993,964,6,0,12,0,3,8,969,944,6,0,11,0,0,8,24,20,0,0,1,0,3,0
250092022006,776,719,10,0,32,0,6,9,759,705,10,0,32,0,3,9,17,14,0,0,0,0,3,0
250092031001,1152,1124,4,0,11,0,2,11,1133,1110,4,0,10,0,0,9,19,14,0,0,1,0,2,2
250092031002,1008,952,10,0,19,0,10,17,959,914,10,0,19,0,2,14,49,38,0,0,0,0,8,3
250092031003,654,616,8,0,20,0,4,6,647,609,8,0,20,0,4,6,7,7,0,0,0,0,0,0
250092031004,1126,1084,2,2,16,0,6,16,1099,1065,2,0,16,0,0,16,27,19,0,2,0,0,6,0
250092031005,929,907,1,3,5,0,5,8,914,903,0,1,5,0,0,5,15,4,1,2,0,0,5,3
250092031006,668,646,6,0,10,0,0,6,659,638,5,0,10,0,0,6,9,8,1,0,0,0,0,0
250092031007,709,676,3,1,12,1,6,10,689,664,0,1,12,1,3,8,20,12,3,0,0,0,3,2
250092031008,825,818,2,0,1,0,3,1,818,814,2,0,1,0,0,1,7,4,0,0,0,0,3,0
250092032001,1136,1111,3,0,6,0,1,15,1129,1106,3,0,5,0,0,15,7,5,0,0,1,0,1,0
250092032002,791,748,10,0,12,0,16,5,759,732,10,0,12,0,0,5,32,16,0,0,0,0,16,0
250092032003,695,676,2,1,8,0,3,5,685,668,2,1,8,0,2,4,10,8,0,0,0,0,1,1
250092032004,881,838,4,3,13,0,7,16,858,824,4,3,11,0,4,12,23,14,0,0,2,0,3,4
250092032005,1054,1043,0,0,2,0,2,7,1042,1031,0,0,2,0,2,7,12,12,0,0,0,0,0,0
250092033011,704,681,4,2,4,0,6,7,695,676,3,2,4,0,3,7,9,5,1,0,0,0,3,0
250092033012,1966,1891,27,1,15,0,7,25,1935,1868,24,1,15,0,6,21,31,23,3,0,0,0,1,4
250092033013,616,578,18,0,5,0,6,9,603,572,18,0,5,0,1,7,13,6,0,0,0,0,5,2
250092033014,724,707,1,1,9,0,0,6,719,704,1,0,9,0,0,5,5,3,0,1,0,0,0,1
250092033021,1214,1182,10,0,5,0,3,14,1191,1163,9,0,5,0,1,13,23,19,1,0,0,0,2,1
250092033022,2088,2002,15,3,26,0,14,28,2039,1973,11,3,26,0,0,26,49,29,4,0,0,0,14,2
250092033023,868,807,21,5,3,0,14,18,818,784,15,0,3,0,3,13,50,23,6,5,0,0,11,5
250092041011,1127,1036,10,10,20,0,31,20,1054,1008,6,1,18,0,7,14,73,28,4,9,2,0,24,6
250092041012,1867,1332,155,13,58,2,197,110,1465,1215,115,1,58,2,7,67,402,117,40,12,0,0,190,43
250092041013,1118,970,34,1,31,0,56,26,1017,936,25,0,31,0,5,20,101,34,9,1,0,0,51,6
250092041014,557,508,7,0,9,0,27,6,519,499,7,0,9,0,0,4,38,9,0,0,0,0,27,2
250092041021,2072,1766,116,8,55,3,86,38,1849,1680,87,0,54,3,2,23,223,86,29,8,1,0,84,15
250092041022,2863,2433,168,10,75,2,116,59,2655,2374,141,7,75,2,8,48,208,59,27,3,0,0,108,11
250092042001,1091,883,51,1,14,0,100,42,884,818,28,1,14,0,1,22,207,65,23,0,0,0,99,20
250092042002,685,388,70,11,19,1,165,31,377,290,49,5,17,1,7,8,308,98,21,6,2,0,158,23
250092042003,1223,1067,52,4,20,0,47,33,1093,1008,39,3,20,0,2,21,130,59,13,1,0,0,45,12
250092042004,829,668,19,4,16,0,86,36,663,610,15,3,16,0,5,14,166,58,4,1,0,0,81,22
250092042005,969,864,24,0,14,0,37,30,889,833,21,0,14,0,4,17,80,31,3,0,0,0,33,13
250092043001,1267,1158,31,1,21,1,35,20,1188,1125,25,0,20,1,1,16,79,33,6,1,1,0,34,4
250092043002,1516,770,180,14,16,0,429,107,499,372,78,8,16,0,8,17,1017,398,102,6,0,0,421,90
250092043003,1121,541,142,10,16,0,295,117,406,303,60,2,16,0,3,22,715,238,82,8,0,0,292,95
250092044001,731,696,7,0,11,0,8,9,712,683,7,0,11,0,2,9,19,13,0,0,0,0,6,0
250092044002,1077,977,21,4,12,2,26,35,1011,947,14,2,12,2,9,25,66,30,7,2,0,0,17,10
250092044003,656,625,5,2,2,0,8,14,630,612,4,2,2,0,1,9,26,13,1,0,0,0,7,5
250092044004,837,775,15,1,4,1,16,25,777,747,12,0,4,1,0,13,60,28,3,1,0,0,16,12
250092045001,1190,1009,46,4,20,1,66,44,1027,941,32,3,20,1,0,30,163,68,14,1,0,0,66,14
250092045002,1163,976,60,9,47,0,33,38,1035,922,30,2,47,0,8,26,128,54,30,7,0,0,25,12
250092045003,779,710,9,1,19,0,19,21,730,689,6,0,16,0,11,8,49,21,3,1,3,0,8,13
250092046001,1225,1093,30,2,32,0,35,33,1124,1045,22,0,32,0,6,19,101,48,8,2,0,0,29,14
250092046002,1311,1115,36,4,17,1,99,39,1148,1052,30,1,14,1,23,27,163,63,6,3,3,0,76,12
250092046003,676,621,11,0,3,0,21,20,620,597,2,0,3,0,4,14,56,24,9,0,0,0,17,6
250092046004,1040,868,36,5,13,0,71,47,893,832,24,1,13,0,5,18,147,36,12,4,0,0,66,29
250092046005,902,826,20,0,15,4,16,21,838,790,16,0,15,0,1,16,64,36,4,0,0,4,15,5
250092047011,785,703,24,0,39,0,11,8,762,692,23,0,39,0,0,8,23,11,1,0,0,0,11,0
250092047012,1530,1067,130,13,60,1,180,79,1146,941,93,7,60,1,7,37,384,126,37,6,0,0,173,42
250092047013,3467,2629,258,24,90,2,314,150,2784,2425,199,7,90,2,1,60,683,204,59,17,0,0,313,90
250092047021,861,683,22,2,41,0,77,36,731,638,20,1,41,0,12,19,130,45,2,1,0,0,65,17
250092047022,2903,2303,186,8,248,0,81,77,2673,2194,169,5,248,0,8,49,230,109,17,3,0,0,73,28
250092047023,1040,887,22,6,23,0,78,24,893,848,9,3,23,0,4,6,147,39,13,3,0,0,74,18
250092047024,862,747,43,1,15,0,43,13,783,711,42,1,15,0,4,10,79,36,1,0,0,0,39,3
250092051001,1192,995,51,1,45,0,64,36,1094,973,49,0,45,0,2,25,98,22,2,1,0,0,62,11
250092051002,1077,760,72,0,52,1,137,55,823,675,62,0,48,1,8,29,254,85,10,0,4,0,129,26
250092051003,919,641,115,0,36,0,101,26,754,596,105,0,36,0,8,9,165,45,10,0,0,0,93,17
250092051004,1527,1360,62,0,30,1,31,43,1477,1341,62,0,30,1,5,38,50,19,0,0,0,0,26,5
250092051005,637,524,54,0,20,0,31,8,564,502,36,0,20,0,0,6,73,22,18,0,0,0,31,2
250092052001,806,647,48,0,10,0,66,35,686,612,41,0,10,0,2,21,120,35,7,0,0,0,64,14
250092052002,714,578,36,0,25,0,50,25,609,541,28,0,25,0,0,15,105,37,8,0,0,0,50,10
250092052003,1510,777,167,6,143,0,349,68,981,670,127,4,139,0,8,33,529,107,40,2,4,0,341,35
250092052004,1435,880,210,2,96,0,197,50,996,691,182,2,96,0,3,22,439,189,28,0,0,0,194,28
250092052005,854,646,85,3,37,1,44,38,732,601,78,1,32,0,2,18,122,45,7,2,5,1,42,20
250092053001,1586,1384,66,2,20,0,55,59,1453,1328,66,2,20,0,4,33,133,56,0,0,0,0,51,26
250092053002,909,746,46,0,27,0,57,33,778,697,37,0,27,0,0,17,131,49,9,0,0,0,57,16
250092053003,926,858,12,0,24,0,12,20,877,824,12,0,24,0,5,12,49,34,0,0,0,0,7,8
250092053004,1069,875,69,5,30,0,74,16,963,848,66,5,30,0,4,10,106,27,3,0,0,0,70,6
250092054001,1948,1801,28,4,55,1,30,29,1885,1767,23,4,55,1,13,22,63,34,5,0,0,0,17,7
250092054002,1584,1482,33,0,18,0,22,29,1535,1459,29,0,18,0,1,28,49,23,4,0,0,0,21,1
250092054003,1516,1355,53,7,35,1,26,39,1451,1324,46,4,34,1,5,37,65,31,7,3,1,0,21,2
250092055001,2054,1333,213,21,84,7,273,123,1383,1066,179,0,84,4,3,47,671,267,34,21,0,3,270,76
250092055002,2552,1064,363,31,233,3,711,147,1298,672,331,7,229,0,11,48,1254,392,32,24,4,3,700,99
250092056001,1258,594,181,1,112,0,258,112,741,471,125,0,110,0,0,35,517,123,56,1,2,0,258,77
250092056002,723,474,130,3,17,0,74,25,591,437,113,1,17,0,2,21,132,37,17,2,0,0,72,4
250092056003,1320,889,218,8,30,0,106,69,1108,840,196,7,28,0,4,33,212,49,22,1,2,0,102,36
250092056004,580,491,30,2,12,0,25,20,526,464,29,2,12,0,5,14,54,27,1,0,0,0,20,6
250092057001,768,646,39,1,23,0,42,17,686,616,38,1,23,0,0,8,82,30,1,0,0,0,42,9
250092057002,937,770,57,0,47,0,45,18,817,719,43,0,45,0,0,10,120,51,14,0,2,0,45,8
250092057003,1072,674,122,5,89,0,123,59,778,555,94,4,89,0,5,31,294,119,28,1,0,0,118,28
250092057004,835,571,61,5,47,0,117,34,615,498,53,0,47,0,6,11,220,73,8,5,0,0,111,23
250092057005,1038,757,89,9,99,0,59,25,836,647,69,9,99,0,1,11,202,110,20,0,0,0,58,14
250092058001,1044,507,138,12,91,5,252,39,600,383,103,1,88,0,8,17,444,124,35,11,3,5,244,22
250092058002,1089,445,106,11,250,0,224,53,609,263,67,0,250,0,3,26,480,182,39,11,0,0,221,27
250092058003,1179,615,174,5,113,1,179,92,805,491,141,0,111,0,10,52,374,124,33,5,2,1,169,40
250092059001,1743,976,209,32,98,5,348,75,1047,754,159,0,95,0,6,33,696,222,50,32,3,5,342,42
250092059002,1262,685,163,9,105,0,248,52,818,539,131,2,105,0,15,26,444,146,32,7,0,0,233,26
250092059003,1345,855,157,10,108,0,149,66,1029,732,138,3,108,0,9,39,316,123,19,7,0,0,140,27
250092060001,1443,552,314,34,105,0,350,88,726,344,250,2,105,0,4,21,717,208,64,32,0,0,346,67
250092060002,1916,628,307,16,178,0,660,127,825,349,248,1,176,0,13,38,1091,279,59,15,2,0,647,89
250092061001,1793,686,408,27,177,1,386,108,953,413,320,7,177,1,4,31,840,273,88,20,0,0,382,77
250092061002,2051,787,308,15,313,9,472,147,997,373,249,6,313,9,6,41,1054,414,59,9,0,0,466,106
250092062001,1128,489,163,16,66,0,338,56,501,258,142,2,65,0,6,28,627,231,21,14,1,0,332,28
250092062002,2267,934,409,22,225,0,529,148,1074,462,332,5,223,0,8,44,1193,472,77,17,2,0,521,104
250092062003,1859,643,287,15,213,0,515,186,847,330,238,1,211,0,9,58,1012,313,49,14,2,0,506,128
250092063001,712,355,80,15,67,0,152,43,470,303,68,3,67,0,1,28,242,52,12,12,0,0,151,15
250092063002,991,322,251,9,60,0,266,83,510,209,194,2,60,0,6,39,481,113,57,7,0,0,260,44
250092063003,1030,399,184,1,109,1,249,87,566,266,157,0,109,0,6,28,464,133,27,1,0,1,243,59
250092063004,1040,487,190,7,90,2,212,52,688,396,165,1,87,2,7,30,352,91,25,6,3,0,205,22
250092064001,1018,359,211,6,112,0,242,88,605,277,168,4,111,0,6,39,413,82,43,2,1,0,236,49
250092064002,1847,1450,120,0,76,4,165,32,1514,1309,106,0,72,3,5,19,333,141,14,0,4,1,160,13
250092064003,1042,625,158,11,47,0,158,43,718,523,123,3,47,0,1,21,324,102,35,8,0,0,157,22
250092064004,1342,807,191,1,47,0,228,68,881,655,143,1,46,0,10,26,461,152,48,0,1,0,218,42
250092065001,943,527,133,5,27,1,189,61,582,414,98,1,27,0,2,40,361,113,35,4,0,1,187,21
250092065002,1267,453,239,8,51,1,445,70,558,275,190,5,48,0,9,31,709,178,49,3,3,1,436,39
250092065003,1148,349,276,5,160,0,267,91,642,208,230,1,157,0,10,36,506,141,46,4,3,0,257,55
250092066001,884,573,86,23,59,2,105,36,681,520,77,9,59,2,0,14,203,53,9,14,0,0,105,22
250092066002,740,595,42,9,40,0,34,20,637,549,34,1,35,0,2,16,103,46,8,8,5,0,32,4
250092066003,1034,707,81,0,51,0,138,57,794,648,67,0,51,0,4,24,240,59,14,0,0,0,134,33
250092066004,1585,831,243,21,140,0,243,107,1103,679,213,5,140,0,7,59,482,152,30,16,0,0,236,48
250092067001,1470,681,237,19,51,2,388,92,809,491,203,7,50,1,7,50,661,190,34,12,1,1,381,42
250092067002,746,651,43,1,4,1,12,34,682,626,36,1,4,0,0,15,64,25,7,0,0,1,12,19
250092067003,682,442,88,2,23,0,87,40,515,397,79,0,23,0,5,11,167,45,9,2,0,0,82,29
250092067004,1182,751,186,1,32,0,144,68,860,645,145,0,31,0,8,31,322,106,41,1,1,0,136,37
250092068001,1754,597,301,38,125,0,566,127,771,365,205,10,124,0,21,46,983,232,96,28,1,0,545,81
250092068002,1792,913,326,26,74,1,348,104,1069,679,260,8,71,1,2,48,723,234,66,18,3,0,346,56
250092069001,641,521,47,4,4,0,54,11,539,489,39,4,4,0,0,3,102,32,8,0,0,0,54,8
250092069002,1910,1038,380,17,66,1,299,109,1341,876,315,6,63,0,18,63,569,162,65,11,3,1,281,46
250092069003,1414,809,272,11,42,2,209,69,1045,732,237,5,40,0,10,21,369,77,35,6,2,2,199,48
250092070001,963,644,127,8,31,4,126,23,722,568,106,6,31,4,1,6,241,76,21,2,0,0,125,17
250092070002,1235,444,299,18,85,0,312,77,598,224,251,2,85,0,0,36,637,220,48,16,0,0,312,41
250092071001,1446,444,218,20,227,17,439,81,693,242,188,3,225,1,10,24,753,202,30,17,2,16,429,57
250092071002,992,303,112,1,206,7,308,55,534,170,95,0,205,5,20,39,458,133,17,1,1,2,288,16
250092071003,1075,373,132,9,250,0,258,53,616,236,106,0,245,0,10,19,459,137,26,9,5,0,248,34
250092072001,1212,432,138,13,283,0,262,84,741,294,113,3,283,0,4,44,471,138,25,10,0,0,258,40
250092072002,1727,763,296,10,115,0,470,73,964,579,246,4,111,0,7,17,763,184,50,6,4,0,463,56
250092081011,956,902,14,1,15,0,19,5,920,885,14,1,15,0,0,5,36,17,0,0,0,0,19,0
250092081012,1710,1562,34,7,39,0,25,43,1599,1487,34,1,37,0,9,31,111,75,0,6,2,0,16,12
250092081013,1086,985,31,2,29,0,12,27,1043,958,28,2,29,0,0,26,43,27,3,0,0,0,12,1
250092081014,1372,1274,23,0,38,0,20,17,1316,1246,23,0,38,0,2,7,56,28,0,0,0,0,18,10
250092081021,752,637,36,0,38,2,17,22,698,613,32,0,38,0,0,15,54,24,4,0,0,2,17,7
250092081022,872,768,28,1,14,0,20,41,803,736,24,1,14,0,4,24,69,32,4,0,0,0,16,17
250092081023,790,739,9,0,31,0,2,9,758,711,8,0,31,0,0,8,32,28,1,0,0,0,2,1
250092081024,829,723,17,1,45,1,27,15,773,695,17,0,45,1,6,9,56,28,0,1,0,0,21,6
250092082001,1228,1140,35,4,12,0,17,20,1187,1124,34,2,12,0,3,12,41,16,1,2,0,0,14,8
250092082002,843,808,6,0,3,0,18,8,819,799,5,0,3,0,5,7,24,9,1,0,0,0,13,1
250092082003,1872,1754,28,2,28,0,38,22,1830,1735,28,1,28,0,21,17,42,19,0,1,0,0,17,5
250092082004,1319,1193,36,1,42,0,23,24,1267,1162,34,0,42,0,13,16,52,31,2,1,0,0,10,8
250092083001,1152,1062,14,0,57,0,3,16,1131,1044,13,0,57,0,3,14,21,18,1,0,0,0,0,2
250092083002,2268,2125,34,10,19,0,51,29,2148,2055,34,10,19,0,5,25,120,70,0,0,0,0,46,4
250092083003,1257,1175,29,5,13,0,30,5,1210,1141,29,5,13,0,17,5,47,34,0,0,0,0,13,0
250092083004,2577,2413,36,2,76,0,28,22,2505,2359,35,2,76,0,16,17,72,54,1,0,0,0,12,5
250092084001,935,902,3,0,22,0,6,2,921,895,3,0,22,0,0,1,14,7,0,0,0,0,6,1
250092084002,1632,1545,21,0,32,0,8,26,1588,1512,17,0,31,0,4,24,44,33,4,0,1,0,4,2
250092084003,1245,1105,36,2,79,0,8,15,1217,1089,35,2,79,0,3,9,28,16,1,0,0,0,5,6
250092084004,1933,1667,82,1,80,0,58,45,1829,1614,78,1,79,0,21,36,104,53,4,0,1,0,37,9
250092091001,1335,1261,6,0,50,0,5,13,1315,1246,6,0,50,0,5,8,20,15,0,0,0,0,0,5
250092091002,617,566,8,0,35,0,2,6,605,556,8,0,35,0,0,6,12,10,0,0,0,0,2,0
250092091003,1503,1440,6,2,39,0,3,13,1474,1415,4,2,39,0,2,12,29,25,2,0,0,0,1,1
250092091004,1102,1058,2,0,27,0,5,10,1089,1047,2,0,27,0,3,10,13,11,0,0,0,0,2,0
250092091005,1531,1383,16,0,90,0,14,28,1482,1355,13,0,90,0,7,17,49,28,3,0,0,0,7,11
250092092001,1214,1175,2,0,23,0,2,12,1199,1163,2,0,23,0,0,11,15,12,0,0,0,0,2,1
250092092002,1354,1304,5,0,28,0,11,6,1346,1300,5,0,28,0,7,6,8,4,0,0,0,0,4,0
250092092003,1395,1326,1,2,50,0,3,13,1374,1309,1,2,50,0,2,10,21,17,0,0,0,0,1,3
250092092004,1545,1473,12,1,37,0,7,15,1510,1447,7,1,37,0,4,14,35,26,5,0,0,0,3,1
250092101001,2639,2498,16,4,69,0,25,27,2582,2466,13,4,69,0,6,24,57,32,3,0,0,0,19,3
250092101002,1440,1385,15,1,27,0,6,6,1402,1358,10,1,27,0,1,5,38,27,5,0,0,0,5,1
250092101003,1506,1475,10,0,16,0,2,3,1479,1452,10,0,16,0,0,1,27,23,0,0,0,0,2,2
250092101004,1363,1313,4,0,21,0,15,10,1333,1298,4,0,21,0,1,9,30,15,0,0,0,0,14,1
250092102001,1399,1312,23,3,28,0,23,10,1354,1290,22,3,28,0,1,10,45,22,1,0,0,0,22,0
250092102002,1827,1733,30,5,35,0,5,19,1801,1710,30,5,35,0,3,18,26,23,0,0,0,0,2,1
250092102003,2158,2093,12,2,22,0,8,21,2126,2071,12,0,20,0,4,19,32,22,0,2,2,0,4,2
250092103001,1640,1289,154,5,94,1,54,43,1527,1246,143,1,93,1,15,28,113,43,11,4,1,0,39,15
250092103002,4536,4331,36,4,100,2,37,26,4455,4282,36,2,97,2,12,24,81,49,0,2,3,0,25,2
250092103003,2934,2713,73,10,76,0,29,33,2790,2618,64,2,70,0,8,28,144,95,9,8,6,0,21,5
250092104001,1582,1404,63,1,69,0,22,23,1519,1369,53,0,68,0,11,18,63,35,10,1,1,0,11,5
250092104002,1092,929,58,5,18,0,48,34,986,884,45,3,18,0,23,13,106,45,13,2,0,0,25,21
250092104003,2450,2249,44,0,36,2,76,43,2316,2193,31,0,35,2,22,33,134,56,13,0,1,0,54,10
250092104004,1699,1608,17,2,41,0,16,15,1666,1590,17,2,41,0,9,7,33,18,0,0,0,0,7,8
250092105001,1107,1024,26,0,24,0,17,16,1052,989,21,0,23,0,8,11,55,35,5,0,1,0,9,5
250092105002,2563,2418,53,2,51,0,11,28,2511,2382,52,2,51,0,1,23,52,36,1,0,0,0,10,5
250092105003,1392,1322,20,2,10,0,24,14,1329,1296,11,0,10,0,2,10,63,26,9,2,0,0,22,4
250092105004,1376,1320,21,3,11,0,12,9,1341,1303,20,2,11,0,0,5,35,17,1,1,0,0,12,4
250092106001,1586,1384,49,6,6,0,105,36,1403,1319,32,6,6,0,17,23,183,65,17,0,0,0,88,13
250092106002,692,650,10,1,11,0,5,15,680,642,10,1,10,0,3,14,12,8,0,0,1,0,2,1
250092106003,1194,1009,46,3,9,0,99,28,1033,978,28,0,9,0,5,13,161,31,18,3,0,0,94,15
250056517002,1140,720,156,11,11,1,155,86,979,644,148,11,11,1,91,73,161,76,8,0,0,0,64,13
250056518001,1037,765,94,10,21,0,96,51,953,728,87,10,21,0,59,48,84,37,7,0,0,0,37,3
250056518002,708,414,78,25,10,1,98,82,513,354,58,8,10,0,32,51,195,60,20,17,0,1,66,31
250056519001,683,315,86,9,4,0,181,88,440,221,70,5,4,0,83,57,243,94,16,4,0,0,98,31
250056519002,1259,431,176,15,12,1,450,174,869,278,144,13,12,1,279,142,390,153,32,2,0,0,171,32
250056520001,629,456,57,5,2,0,81,28,588,439,52,5,2,0,64,26,41,17,5,0,0,0,17,2
250056520002,887,501,90,8,6,4,170,108,782,463,86,3,6,0,123,101,105,38,4,5,0,4,47,7
250056520003,1160,884,60,16,2,0,124,74,977,818,46,9,1,0,44,59,183,66,14,7,1,0,80,15
250056521001,698,558,46,5,6,0,41,42,675,545,46,5,6,0,34,39,23,13,0,0,0,0,7,3
250056521002,838,685,50,1,4,0,47,51,784,658,44,1,4,0,27,50,54,27,6,0,0,0,20,1
250056521003,1279,1018,53,7,11,0,102,88,1132,957,39,6,11,0,44,75,147,61,14,1,0,0,58,13
250056522001,1089,943,39,5,6,0,44,52,1039,916,37,3,6,0,30,47,50,27,2,2,0,0,14,5
250056522002,979,878,22,4,10,0,39,26,950,865,21,4,10,0,26,24,29,13,1,0,0,0,13,2
250056522003,768,692,31,4,3,0,17,21,743,674,28,3,3,0,15,20,25,18,3,1,0,0,2,1
250056523001,1018,890,24,1,2,0,60,41,919,839,21,1,2,0,17,39,99,51,3,0,0,0,43,2
250056523002,1044,705,87,5,6,0,160,81,796,613,65,5,6,0,54,53,248,92,22,0,0,0,106,28
250056523003,808,719,17,12,1,0,30,29,754,690,14,0,1,0,23,26,54,29,3,12,0,0,7,3
250056524001,1392,1119,60,10,13,0,130,60,1129,1004,55,4,13,0,15,38,263,115,5,6,0,0,115,22
250056524002,1272,1091,52,1,13,0,69,46,1159,1042,32,1,13,0,30,41,113,49,20,0,0,0,39,5
250056525001,1179,872,74,19,0,1,160,53,997,796,62,9,0,0,94,36,182,76,12,10,0,1,66,17
250056525002,1410,1017,61,13,28,1,231,59,1008,841,45,2,27,0,61,32,402,176,16,11,1,1,170,27
250056526001,1295,896,81,22,6,0,163,127,818,671,45,1,4,0,30,67,477,225,36,21,2,0,133,60
250056526002,1548,869,158,82,0,10,344,85,806,606,89,18,0,0,60,33,742,263,69,64,0,10,284,52
250056527001,888,572,58,6,10,0,178,64,524,368,46,0,10,0,45,55,364,204,12,6,0,0,133,9
250056527002,1070,764,59,18,5,0,151,73,760,611,49,8,5,0,40,47,310,153,10,10,0,0,111,26
250056527003,1027,824,38,3,0,0,104,58,890,766,31,2,0,0,45,46,137,58,7,1,0,0,59,12
250056527004,777,529,53,3,0,0,138,54,495,405,39,2,0,0,20,29,282,124,14,1,0,0,118,25
250056528001,1153,1073,13,3,6,0,34,24,1111,1051,13,2,6,0,15,24,42,22,0,1,0,0,19,0
250056528002,1113,1013,21,1,0,0,39,39,1059,987,19,1,0,0,21,31,54,26,2,0,0,0,18,8
250056528003,1011,917,16,0,6,0,41,31,936,869,15,0,6,0,18,28,75,48,1,0,0,0,23,3
250056531011,1059,988,4,4,36,0,16,11,1043,977,4,4,36,0,11,11,16,11,0,0,0,0,5,0
250056531012,1363,1287,10,0,34,1,13,18,1344,1272,10,0,34,1,9,18,19,15,0,0,0,0,4,0
250056531013,2760,2457,76,3,84,2,46,92,2673,2395,73,3,84,2,30,86,87,62,3,0,0,0,16,6
250056531014,1482,1399,6,2,42,0,16,17,1458,1382,6,2,40,0,14,14,24,17,0,0,2,0,2,3
250056531021,2204,2117,15,0,12,0,15,45,2169,2100,10,0,11,0,8,40,35,17,5,0,1,0,7,5
250056531022,3177,2688,282,13,70,1,73,50,2946,2523,275,11,68,1,26,42,231,165,7,2,2,0,47,8
250056532031,1251,1173,7,2,4,0,28,37,1231,1163,6,2,4,0,20,36,20,10,1,0,0,0,8,1
250056532032,1458,1318,29,3,27,0,50,31,1436,1312,28,1,27,0,42,26,22,6,1,2,0,0,8,5
250056532033,1472,1385,12,8,30,0,21,16,1452,1374,12,2,30,0,20,14,20,11,0,6,0,0,1,2
250056532034,824,782,3,3,12,0,18,6,811,771,3,3,12,0,16,6,13,11,0,0,0,0,2,0
250056532041,3214,2953,41,3,114,0,40,63,3168,2920,36,3,114,0,35,60,46,33,5,0,0,0,5,3
250056533011,1442,1373,6,2,20,0,18,23,1410,1354,6,1,20,0,6,23,32,19,0,1,0,0,12,0
250056533012,552,536,4,0,3,0,7,2,543,527,4,0,3,0,7,2,9,9,0,0,0,0,0,0
250056533013,1300,1223,19,1,23,0,13,21,1288,1214,19,1,23,0,11,20,12,9,0,0,0,0,2,1
250056533014,799,773,0,2,12,0,0,12,781,757,0,2,10,0,0,12,18,16,0,0,2,0,0,0
250056533015,964,939,9,0,2,0,5,9,956,933,9,0,2,0,4,8,8,6,0,0,0,0,1,1
250056533041,1110,1057,4,6,13,0,8,22,1105,1054,4,5,13,0,7,22,5,3,0,1,0,0,1,0
250056533042,2095,2041,6,2,10,0,12,24,2071,2024,3,1,10,0,11,22,24,17,3,1,0,0,1,2
250056541001,1795,1750,12,3,3,0,11,16,1776,1735,12,3,3,0,8,15,19,15,0,0,0,0,3,1
250056541002,627,598,3,0,6,0,10,10,621,593,3,0,6,0,9,10,6,5,0,0,0,0,1,0
250056541003,1792,1758,10,1,5,0,11,7,1769,1738,9,1,5,0,11,5,23,20,1,0,0,0,0,2
250056541004,2702,2645,10,3,11,0,14,19,2678,2623,10,3,11,0,12,19,24,22,0,0,0,0,2,0
250056542001,859,836,3,0,2,0,5,13,843,823,3,0,2,0,5,10,16,13,0,0,0,0,0,3
250056542002,1221,1168,4,4,4,0,15,26,1211,1163,4,4,4,0,13,23,10,5,0,0,0,0,2,3
250056542003,1307,1256,7,5,0,0,12,27,1286,1244,7,5,0,0,5,25,21,12,0,0,0,0,7,2
250056551001,1402,1332,14,0,5,5,23,23,1389,1324,14,0,5,5,18,23,13,8,0,0,0,0,5,0
250056551002,2238,2115,27,5,29,0,28,34,2213,2098,27,3,29,0,25,31,25,17,0,2,0,0,3,3
250056551003,585,560,4,1,8,0,9,3,571,550,4,1,8,0,5,3,14,10,0,0,0,0,4,0
250056552001,1178,1131,9,2,8,0,16,12,1159,1124,8,2,7,0,8,10,19,7,1,0,1,0,8,2
250056552002,1074,1024,10,5,8,1,12,14,1058,1015,7,5,8,1,8,14,16,9,3,0,0,0,4,0
250056552003,720,675,12,1,3,1,11,17,696,662,12,1,3,1,3,14,24,13,0,0,0,0,8,3
250056552004,735,707,8,2,8,0,3,7,729,701,8,2,8,0,3,7,6,6,0,0,0,0,0,0
250056552005,708,648,13,1,20,2,6,18,700,644,13,1,20,2,2,18,8,4,0,0,0,0,4,0
250056553001,1421,1372,14,0,7,0,18,10,1413,1366,14,0,7,0,16,10,8,6,0,0,0,0,2,0
250056553002,871,839,9,2,7,0,8,6,850,820,8,2,7,0,7,6,21,19,1,0,0,0,1,0
250056553003,1025,983,7,1,13,0,9,12,1014,976,7,1,13,0,7,10,11,7,0,0,0,0,2,2
250056554001,1329,1283,3,2,14,0,7,20,1317,1274,3,2,14,0,5,19,12,9,0,0,0,0,2,1
250056554002,955,924,6,0,7,0,10,8,949,919,6,0,7,0,9,8,6,5,0,0,0,0,1,0
250056554003,780,745,6,0,10,0,5,14,773,740,6,0,10,0,4,13,7,5,0,0,0,0,1,1
250056554004,852,828,3,3,7,0,5,6,844,821,3,3,6,0,5,6,8,7,0,0,1,0,0,0
250059855001,5506,4834,336,7,103,2,94,130,5342,4750,316,7,101,2,49,117,164,84,20,0,2,0,45,13
250059856001,5205,4864,134,2,76,1,64,64,5056,4774,128,1,75,0,23,55,149,90,6,1,1,1,41,9
250056112012,2177,2089,18,0,30,0,2,38,2145,2066,17,0,30,0,0,32,32,23,1,0,0,0,2,6
250056112021,2887,2745,25,4,56,9,5,43,2828,2703,22,1,56,3,2,41,59,42,3,3,0,6,3,2
250056112022,1890,1762,46,3,33,0,14,32,1857,1742,45,3,33,0,5,29,33,20,1,0,0,0,9,3
250056112023,1619,1542,25,2,17,0,10,23,1595,1531,22,1,17,0,6,18,24,11,3,1,0,0,4,5
250056121001,1048,975,29,2,28,0,6,8,1037,970,28,2,28,0,2,7,11,5,1,0,0,0,4,1
250056121002,2410,2285,41,1,45,0,10,28,2374,2259,41,1,39,0,7,27,36,26,0,0,6,0,3,1
250056121003,1080,1025,15,0,13,0,13,14,1057,1018,15,0,13,0,7,4,23,7,0,0,0,0,6,10
250056122001,2442,2199,87,11,38,0,29,78,2404,2181,87,11,37,0,14,74,38,18,0,0,1,0,15,4
250056122002,1226,1157,22,1,26,0,13,7,1208,1146,22,0,26,0,7,7,18,11,0,1,0,0,6,0
250056122003,2997,2838,67,1,38,0,21,32,2949,2805,67,1,37,0,12,27,48,33,0,0,1,0,9,5
250056122004,2180,1994,89,11,29,0,11,46,2107,1940,84,8,29,0,9,37,73,54,5,3,0,0,2,9
250056131001,1768,1591,58,1,29,0,40,49,1711,1565,54,0,29,0,24,39,57,26,4,1,0,0,16,10
250056131002,1805,1658,45,3,19,0,43,37,1759,1639,43,3,19,0,24,31,46,19,2,0,0,0,19,6
250056131003,1539,1460,30,6,16,0,7,20,1520,1446,30,6,16,0,5,17,19,14,0,0,0,0,2,3
250056131004,1215,1140,14,1,10,2,25,23,1182,1125,13,1,10,2,11,20,33,15,1,0,0,0,14,3
250056133001,1535,1437,26,5,14,0,15,38,1498,1427,24,2,14,0,3,28,37,10,2,3,0,0,12,10
250056133002,2006,1861,50,8,9,2,35,41,1947,1826,48,8,6,2,26,31,59,35,2,0,3,0,9,10
250056133003,1757,1667,38,1,10,3,16,22,1733,1655,37,0,10,3,9,19,24,12,1,1,0,0,7,3
250056133004,1903,1829,30,0,8,0,22,14,1854,1789,27,0,8,0,16,14,49,40,3,0,0,0,6,0
250056134001,2154,1997,43,3,30,0,33,48,2110,1968,41,3,30,0,23,45,44,29,2,0,0,0,10,3
250056134002,1658,1295,155,12,14,0,74,108,1413,1180,121,4,14,0,20,74,245,115,34,8,0,0,54,34
250056136001,2059,1777,107,4,3,0,72,96,1941,1718,99,4,3,0,43,74,118,59,8,0,0,0,29,22
250056136002,1712,1456,110,6,6,1,58,75,1573,1382,100,5,6,1,25,54,139,74,10,1,0,0,33,21
250056137001,2453,2194,101,0,27,0,68,63,2370,2155,97,0,27,0,34,57,83,39,4,0,0,0,34,6
250056137002,1916,1622,114,4,12,0,70,94,1776,1557,105,1,11,0,23,79,140,65,9,3,1,0,47,15
250056138001,662,526,54,2,17,1,30,32,623,505,54,2,15,1,15,31,39,21,0,0,2,0,15,1
250056138002,1750,1360,142,18,25,1,90,114,1607,1299,130,17,22,0,49,90,143,61,12,1,3,1,41,24
250056138003,946,742,66,16,9,0,75,38,842,689,65,8,9,0,39,32,104,53,1,8,0,0,36,6
250056138004,1161,934,98,3,3,1,74,48,1027,869,91,3,3,1,28,32,134,65,7,0,0,0,46,16
250056139011,1332,1055,115,5,6,0,85,66,1213,1004,92,5,6,0,56,50,119,51,23,0,0,0,29,16
250056139012,1469,1211,123,3,3,0,80,49,1350,1150,116,2,3,0,36,43,119,61,7,1,0,0,44,6
250056139021,1328,1221,54,6,1,0,33,13,1278,1192,49,6,1,0,20,10,50,29,5,0,0,0,13,3
250056139022,1915,1669,79,7,13,4,69,74,1796,1608,73,7,12,0,33,63,119,61,6,0,1,4,36,11
250056139023,1508,1396,31,1,16,0,36,28,1478,1378,30,1,16,0,26,27,30,18,1,0,0,0,10,1
250056140001,2073,1428,198,4,24,1,242,176,1665,1274,158,2,22,1,78,130,408,154,40,2,2,0,164,46
250056140002,2399,2007,146,7,32,0,99,108,2257,1947,133,7,32,0,54,84,142,60,13,0,0,0,45,24
250056141011,2888,2533,149,2,68,0,32,104,2817,2491,146,0,68,0,22,90,71,42,3,2,0,0,10,14
250056141012,1796,1522,126,2,9,0,64,73,1692,1466,116,2,9,0,32,67,104,56,10,0,0,0,32,6
250056141013,2149,1708,224,6,44,7,68,92,1986,1619,202,4,42,6,35,78,163,89,22,2,2,1,33,14
250056141021,2442,2239,88,3,32,0,35,45,2347,2182,83,3,32,0,15,32,95,57,5,0,0,0,20,13
250056141022,2466,2223,122,2,23,2,45,49,2384,2165,116,1,23,1,35,43,82,58,6,1,0,1,10,6
250056141023,2110,1984,37,1,28,0,15,45,2067,1951,36,1,28,0,8,43,43,33,1,0,0,0,7,2
250056151001,1095,1074,6,0,5,0,0,10,1091,1070,6,0,5,0,0,10,4,4,0,0,0,0,0,0
250056151002,1487,1442,6,4,9,0,8,18,1451,1419,6,4,7,0,2,13,36,23,0,0,2,0,6,5
250056151003,1423,1378,15,1,9,0,2,18,1404,1360,15,1,9,0,1,18,19,18,0,0,0,0,1,0
250056151004,925,902,10,0,3,0,1,9,915,898,10,0,3,0,1,3,10,4,0,0,0,0,0,6
250056151005,2156,2052,19,7,21,0,12,45,2121,2022,18,7,21,0,10,43,35,30,1,0,0,0,2,2
250056161001,1951,1886,22,1,3,0,14,25,1913,1860,20,1,3,0,10,19,38,26,2,0,0,0,4,6
250056161002,2693,2593,27,4,16,0,14,39,2647,2554,26,3,15,0,10,39,46,39,1,1,1,0,4,0
250056161003,1767,1715,9,2,10,1,18,12,1761,1711,9,2,9,1,17,12,6,4,0,0,1,0,1,0
250056171011,1290,1238,16,3,13,0,11,9,1275,1234,16,3,13,0,0,9,15,4,0,0,0,0,11,0
250056171012,840,821,4,4,2,0,1,8,828,812,4,1,2,0,1,8,12,9,0,3,0,0,0,0
250056171013,1056,1030,9,0,9,0,4,4,1043,1019,8,0,9,0,3,4,13,11,1,0,0,0,1,0
250056171014,1495,1456,1,0,5,0,21,12,1476,1446,1,0,5,0,12,12,19,10,0,0,0,0,9,0
250056171015,0,0,0,0,0,0,0,0,0,0,0,0,0,0,0,0,0,0,0,0,0,0,0,0
250056171021,1761,1688,9,3,3,0,32,26,1739,1673,8,2,3,0,30,23,22,15,1,1,0,0,2,3
250056171022,2428,2317,42,3,23,0,14,29,2400,2296,40,3,23,0,11,27,28,21,2,0,0,0,3,2
250056301011,853,785,5,2,45,0,6,10,822,761,4,2,45,0,1,9,31,24,1,0,0,0,5,1
250056301012,2002,1819,41,11,41,1,46,43,1911,1778,40,10,40,1,4,38,91,41,1,1,1,0,42,5
250056301021,1070,998,18,4,17,0,12,21,1029,971,18,4,17,0,1,18,41,27,0,0,0,0,11,3
250056301022,855,804,11,14,12,1,9,4,815,784,11,3,12,1,0,4,40,20,0,11,0,0,9,0
250056301023,1220,1125,21,2,29,0,17,26,1183,1103,21,2,29,0,5,23,37,22,0,0,0,0,12,3
250056301024,1056,960,21,4,39,0,12,20,1022,945,19,3,39,0,0,16,34,15,2,1,0,0,12,4
250056302001,1041,1033,0,1,1,0,2,4,1032,1024,0,1,1,0,2,4,9,9,0,0,0,0,0,0
250056302002,2023,1941,18,0,52,0,1,11,2005,1924,18,0,52,0,1,10,18,17,0,0,0,0,0,1
250056302003,842,794,12,0,24,0,5,7,814,776,10,0,23,0,0,5,28,18,2,0,1,0,5,2
250056302004,937,865,31,0,5,0,10,26,907,852,30,0,5,0,0,20,30,13,1,0,0,0,10,6
250056302005,3361,3059,55,1,167,0,14,65,3328,3039,55,0,166,0,11,57,33,20,0,1,1,0,3,8
250056303001,2283,2146,30,0,71,0,8,28,2259,2127,30,0,71,0,5,26,24,19,0,0,0,0,3,2
250056303002,3750,3383,55,6,203,3,27,73,3653,3315,55,1,201,3,12,66,97,68,0,5,2,0,15,7
250056303003,1170,1105,7,0,24,2,10,22,1141,1089,7,0,24,2,1,18,29,16,0,0,0,0,9,4
250056303004,1394,1314,26,0,39,0,9,6,1376,1301,26,0,39,0,5,5,18,13,0,0,0,0,4,1
250056304001,1537,1465,9,2,25,0,12,24,1498,1441,9,2,25,0,4,17,39,24,0,0,0,0,8,7
250056304002,1684,1610,7,0,29,0,14,24,1650,1591,5,0,29,0,5,20,34,19,2,0,0,0,9,4
250056304003,1634,1341,60,4,185,0,14,30,1592,1308,59,4,183,0,8,30,42,33,1,0,2,0,6,0
250056311001,955,897,21,0,15,0,6,16,908,860,19,0,15,0,1,13,47,37,2,0,0,0,5,3
250056311002,635,553,9,1,37,0,14,21,603,538,9,1,37,0,3,15,32,15,0,0,0,0,11,6
250056311003,1430,1292,31,2,57,1,18,29,1389,1261,30,2,57,1,10,28,41,31,1,0,0,0,8,1
250056311004,1108,1043,19,0,12,0,21,13,1066,1022,17,0,12,0,3,12,42,21,2,0,0,0,18,1
250056311005,1642,1456,56,2,85,1,22,20,1596,1439,51,2,85,1,4,14,46,17,5,0,0,0,18,6
250056311006,1214,1096,32,0,62,0,14,10,1179,1070,32,0,62,0,5,10,35,26,0,0,0,0,9,0
250056311007,1109,979,37,2,42,2,32,15,1043,929,37,2,42,0,20,13,66,50,0,0,0,2,12,2
250056312001,1223,1149,12,1,36,0,15,10,1188,1126,11,1,36,0,7,7,35,23,1,0,0,0,8,3
250056312002,768,694,20,3,34,0,6,11,737,667,20,3,34,0,4,9,31,27,0,0,0,0,2,2
250056312003,1308,1154,36,2,60,0,37,19,1217,1108,35,1,60,0,2,11,91,46,1,1,0,0,35,8
250056312004,1497,1314,49,0,96,0,15,23,1440,1276,49,0,96,0,0,19,57,38,0,0,0,0,15,4
250056312005,2045,1798,70,3,91,1,27,55,1978,1754,68,3,91,1,12,49,67,44,2,0,0,0,15,6
250056313001,1806,1658,27,0,61,0,27,33,1761,1638,27,0,61,0,8,27,45,20,0,0,0,0,19,6
250056313002,1715,1555,41,5,62,0,23,29,1656,1522,37,3,62,0,5,27,59,33,4,2,0,0,18,2
250056313003,1662,1408,70,3,59,6,73,43,1517,1343,67,2,57,3,11,34,145,65,3,1,2,3,62,9
250056314001,1497,997,74,10,149,0,182,85,1062,779,72,3,149,0,9,50,435,218,2,7,0,0,173,35
250056314002,1177,1006,53,3,33,1,54,27,1095,978,51,3,33,1,10,19,82,28,2,0,0,0,44,8
250056315001,1822,1555,76,5,43,2,94,47,1664,1497,76,5,41,0,6,39,158,58,0,0,2,2,88,8
250056315002,975,865,17,2,17,0,24,50,920,842,15,1,17,0,1,44,55,23,2,1,0,0,23,6
250056316001,1518,1072,100,6,120,2,143,75,1205,931,90,6,120,2,9,47,313,141,10,0,0,0,134,28
250056316002,1025,705,29,22,152,4,82,31,829,628,24,1,152,1,5,18,196,77,5,21,0,3,77,13
250056316003,1412,1163,29,3,76,5,87,49,1256,1109,29,3,75,5,5,30,156,54,0,0,1,0,82,19
250056317001,1221,1061,42,5,50,3,28,32,1162,1040,42,5,50,3,1,21,59,21,0,0,0,0,27,11
250056317002,1656,1408,72,2,79,0,62,33,1534,1358,71,2,79,0,5,19,122,50,1,0,0,0,57,14
250056317003,1809,1698,30,0,47,6,2,26,1778,1679,28,0,47,6,0,18,31,19,2,0,0,0,2,8
250056317004,1785,1703,8,1,37,0,9,27,1756,1679,8,1,37,0,4,27,29,24,0,0,0,0,5,0
250056318001,2693,2467,75,5,92,0,21,33,2613,2407,74,5,92,0,8,27,80,60,1,0,0,0,13,6
250056318002,1366,1225,15,0,102,0,1,23,1341,1203,15,0,102,0,0,21,25,22,0,0,0,0,1,2
250056318003,2293,2007,85,3,89,2,46,61,2198,1960,81,2,89,2,8,56,95,47,4,1,0,0,38,5
250056318004,1227,997,64,7,83,3,49,24,1137,965,62,7,83,1,3,16,90,32,2,0,0,2,46,8
250056321001,1251,1194,6,5,14,0,10,22,1224,1179,6,1,14,0,4,20,27,15,0,4,0,0,6,2
250056321002,1167,1130,11,1,13,0,3,9,1152,1122,8,1,13,0,2,6,15,8,3,0,0,0,1,3
250056321003,815,776,6,0,4,0,15,14,795,766,6,0,4,0,6,13,20,10,0,0,0,0,9,1
250056321004,722,693,5,3,10,0,5,6,713,685,5,3,10,0,4,6,9,8,0,0,0,0,1,0
250056321005,887,863,4,1,0,0,8,11,876,854,4,1,0,0,6,11,11,9,0,0,0,0,2,0
250056321006,1701,1638,15,5,13,1,13,16,1688,1631,14,3,13,1,11,15,13,7,1,2,0,0,2,1
250056322001,1192,1115,12,6,18,0,21,20,1164,1102,12,6,18,0,8,18,28,13,0,0,0,0,13,2
250056322002,1736,1643,20,6,30,0,10,27,1694,1612,15,6,30,0,6,25,42,31,5,0,0,0,4,2
250056322003,1978,1869,32,1,16,0,25,35,1933,1836,32,0,16,0,18,31,45,33,0,1,0,0,7,4
250056322004,1171,1109,8,0,28,1,13,12,1153,1100,8,0,28,1,5,11,18,9,0,0,0,0,8,1
250056322005,1102,1028,28,2,20,0,8,16,1079,1011,27,2,20,0,3,16,23,17,1,0,0,0,5,0
250056331001,2448,2348,13,3,39,2,17,26,2404,2320,13,3,39,2,7,20,44,28,0,0,0,0,10,6
250056331002,3042,2941,17,1,27,2,19,35,3008,2919,15,1,25,2,11,35,34,22,2,0,2,0,8,0
250056332001,3274,3166,19,9,26,1,13,40,3229,3140,18,9,26,0,2,34,45,26,1,0,0,1,11,6
250056332002,1589,1532,7,7,9,0,11,23,1555,1508,7,7,9,0,6,18,34,24,0,0,0,0,5,5
250056332003,1255,1217,4,2,16,0,1,15,1229,1197,3,2,16,0,0,11,26,20,1,0,0,0,1,4
250056401001,1110,920,82,7,50,0,21,30,951,793,67,4,50,0,9,28,159,127,15,3,0,0,12,2
250056401002,869,622,54,8,37,0,107,41,662,552,36,3,35,0,6,30,207,70,18,5,2,0,101,11
250056401003,644,584,10,1,27,0,12,10,618,568,10,1,27,0,2,10,26,16,0,0,0,0,10,0
250056401004,1268,1077,36,0,82,0,40,33,1148,1004,28,0,81,0,6,29,120,73,8,0,1,0,34,4
250056401005,1467,1414,11,1,5,0,12,24,1432,1391,11,1,5,0,4,20,35,23,0,0,0,0,8,4
250056402001,1067,967,41,2,4,0,25,28,1025,952,36,2,4,0,7,24,42,15,5,0,0,0,18,4
250056402002,626,575,14,1,18,2,9,7,608,565,14,1,18,2,2,6,18,10,0,0,0,0,7,1
250056402003,1113,962,25,10,40,0,28,48,1049,926,24,5,40,0,9,45,64,36,1,5,0,0,19,3
250056402004,1714,1569,22,4,38,0,36,45,1659,1550,19,4,38,0,9,39,55,19,3,0,0,0,27,6
250056402005,1434,1203,58,7,8,0,86,72,1275,1138,47,6,8,0,25,51,159,65,11,1,0,0,61,21
250056403001,1471,1015,111,12,123,0,160,50,1017,769,69,7,123,0,14,35,454,246,42,5,0,0,146,15
250056403002,1032,966,37,0,1,0,9,19,1010,953,34,0,1,0,4,18,22,13,3,0,0,0,5,1
250056403003,1190,1045,65,4,6,0,17,53,1105,999,54,4,6,0,2,40,85,46,11,0,0,0,15,13
250056404001,651,598,23,0,1,0,12,17,630,589,23,0,1,0,4,13,21,9,0,0,0,0,8,4
250056404002,932,860,14,1,9,0,14,34,916,854,14,1,9,0,9,29,16,6,0,0,0,0,5,5
250056404003,1099,1041,16,4,14,0,14,10,1066,1018,16,4,14,0,4,10,33,23,0,0,0,0,10,0
250056405001,812,714,29,2,7,0,28,32,751,691,25,2,4,0,6,23,61,23,4,0,3,0,22,9
250056405002,750,651,26,1,15,0,28,29,699,628,22,1,15,0,11,22,51,23,4,0,0,0,17,7
250056405003,856,760,29,1,12,0,25,29,790,730,22,1,12,0,5,20,66,30,7,0,0,0,20,9
250056405004,1094,993,31,6,25,0,19,20,1051,968,25,6,25,0,7,20,43,25,6,0,0,0,12,0
250056405005,1653,1525,29,3,11,0,38,47,1585,1495,27,2,11,0,12,38,68,30,2,1,0,0,26,9
250056406001,941,742,64,1,30,0,61,43,841,712,55,1,30,0,11,32,100,30,9,0,0,0,50,11
250056406002,1021,926,24,2,28,0,15,26,990,907,24,1,28,0,8,22,31,19,0,1,0,0,7,4
250092531001,975,886,23,7,36,0,18,5,894,832,19,7,36,0,0,0,81,54,4,0,0,0,18,5
250092531002,1013,902,16,3,40,0,21,31,956,866,15,3,40,0,3,29,57,36,1,0,0,0,18,2
250092531003,1150,1102,1,1,30,0,9,7,1113,1078,1,1,30,0,1,2,37,24,0,0,0,0,8,5
250092531004,1514,1383,54,0,39,2,11,25,1423,1316,45,0,39,2,0,21,91,67,9,0,0,0,11,4
250092531005,700,621,25,0,18,0,15,21,645,592,20,0,18,0,0,15,55,29,5,0,0,0,15,6
250092532011,2042,1861,12,1,114,0,26,28,1910,1763,9,1,114,0,4,19,132,98,3,0,0,0,22,9
250092532012,871,787,17,0,40,0,15,12,831,764,15,0,40,0,2,10,40,23,2,0,0,0,13,2
250092532021,659,582,12,0,54,0,1,10,642,566,12,0,54,0,0,10,17,16,0,0,0,0,1,0
250092532022,2363,1736,145,1,244,0,178,59,2036,1630,129,0,242,0,7,28,327,106,16,1,2,0,171,31
250092532023,983,823,29,0,47,0,61,23,881,796,20,0,47,0,3,15,102,27,9,0,0,0,58,8
250092532024,2248,1892,80,0,182,2,51,41,2049,1773,59,0,182,1,1,33,199,119,21,0,0,1,50,8
250092532031,1008,971,2,0,22,0,5,8,982,950,2,0,22,0,0,8,26,21,0,0,0,0,5,0
250092532032,1647,1511,16,4,90,0,7,19,1617,1490,16,4,90,0,2,15,30,21,0,0,0,0,5,4
250092532033,1505,1429,9,2,56,0,3,6,1495,1420,9,2,56,0,2,6,10,9,0,0,0,0,1,0
250092532041,1287,1042,10,1,211,0,3,20,1248,1013,7,1,211,0,0,16,39,29,3,0,0,0,3,4
250092532042,3253,2954,19,7,209,0,16,48,3195,2919,17,3,209,0,1,46,58,35,2,4,0,0,15,2
250092532043,789,574,8,0,192,0,4,11,773,562,8,0,191,0,1,11,16,12,0,0,1,0,3,0
250092532051,2588,2456,17,1,74,0,10,30,2545,2427,15,0,74,0,2,27,43,29,2,1,0,0,8,3
250092532052,1757,1632,11,0,89,0,4,21,1719,1598,9,0,88,0,3,21,38,34,2,0,1,0,1,0
250092541001,1301,1070,16,1,173,6,12,23,1263,1052,15,1,171,6,2,16,38,18,1,0,2,0,10,7
250092541002,1252,1153,9,1,63,0,14,12,1216,1130,9,1,63,0,1,12,36,23,0,0,0,0,13,0
250092541003,1746,1496,7,1,184,0,25,33,1706,1477,6,1,184,0,13,25,40,19,1,0,0,0,12,8
250092541004,837,795,6,0,33,0,1,2,819,779,5,0,33,0,0,2,18,16,1,0,0,0,1,0
250092541005,873,735,14,1,82,1,14,26,842,722,14,1,82,0,0,23,31,13,0,0,0,1,14,3
250092542001,2739,2483,40,3,79,2,75,57,2569,2410,39,3,73,1,2,41,170,73,1,0,6,1,73,16
250092542002,1148,1058,19,0,40,0,10,21,1114,1037,18,0,40,0,0,19,34,21,1,0,0,0,10,2
250092542003,1131,968,24,0,106,1,7,25,1069,925,20,0,106,1,1,16,62,43,4,0,0,0,6,9
250092543011,2150,1934,41,1,129,0,1,44,2104,1907,32,1,129,0,0,35,46,27,9,0,0,0,1,9
250092543012,1743,1498,11,0,203,0,11,20,1712,1477,10,0,203,0,5,17,31,21,1,0,0,0,6,3
250092543021,2462,2179,8,5,213,0,7,50,2425,2154,8,3,210,0,4,46,37,25,0,2,3,0,3,4
250092543022,1002,851,14,0,128,0,1,8,977,830,12,0,127,0,0,8,25,21,2,0,1,0,1,0
250092543023,1029,878,8,0,118,0,11,14,1010,865,8,0,118,0,6,13,19,13,0,0,0,0,5,1
250092544011,3235,2740,44,0,364,0,36,51,3106,2651,38,0,361,0,12,44,129,89,6,0,3,0,24,7
250092544021,1159,887,12,4,202,0,34,20,1093,863,11,3,201,0,0,15,66,24,1,1,1,0,34,5
250092544022,2241,1861,28,1,297,0,10,44,2186,1822,27,1,294,0,3,39,55,39,1,0,3,0,7,5
250092544023,1515,1246,8,0,233,0,11,17,1486,1223,8,0,232,0,6,17,29,23,0,0,1,0,5,0
250092544024,1798,1145,54,6,430,1,110,52,1570,1060,37,0,430,0,10,33,228,85,17,6,0,1,100,19
250092544031,2620,2291,19,0,263,0,23,24,2537,2235,17,0,260,0,7,18,83,56,2,0,3,0,16,6
250092544032,1220,1092,9,0,98,0,4,17,1201,1079,9,0,98,0,1,14,19,13,0,0,0,0,3,3
250092601001,2048,1339,185,15,49,5,348,107,1147,911,117,2,47,0,20,50,901,428,68,13,2,5,328,57
250092601002,1223,910,104,5,8,0,147,49,830,715,80,3,6,0,6,20,393,195,24,2,2,0,141,29
250092601003,1518,1265,56,6,23,1,118,49,1071,989,30,3,21,0,8,20,447,276,26,3,2,1,110,29
250092602001,1823,1396,122,16,8,0,213,68,1389,1226,97,15,8,0,2,41,434,170,25,1,0,0,211,27
250092602002,1614,1397,65,8,7,0,90,47,1409,1305,52,3,7,0,8,34,205,92,13,5,0,0,82,13
250092603011,1674,1558,26,1,25,0,35,29,1602,1525,26,0,25,0,5,21,72,33,0,1,0,0,30,8
250092603012,1774,1657,24,3,37,0,36,17,1687,1614,20,2,36,0,0,15,87,43,4,1,1,0,36,2
250092603013,1018,956,16,0,3,0,33,10,970,938,14,0,3,0,5,10,48,18,2,0,0,0,28,0
250092603021,935,889,1,1,14,0,2,28,905,869,0,0,14,0,2,20,30,20,1,1,0,0,0,8
250092603022,2156,2077,25,0,24,1,18,11,2107,2045,24,0,24,1,5,8,49,32,1,0,0,0,13,3
250092604011,756,714,4,0,18,0,8,12,730,695,4,0,18,0,2,11,26,19,0,0,0,0,6,1
250092604012,1108,1043,20,1,14,0,22,8,1056,1017,17,1,14,0,0,7,52,26,3,0,0,0,22,1
250092604013,774,728,16,0,18,0,4,8,747,708,15,0,18,0,0,6,27,20,1,0,0,0,4,2
250092604014,1182,1045,22,0,29,0,61,25,1077,1000,19,0,29,0,7,22,105,45,3,0,0,0,54,3
250092604021,2236,2054,43,2,23,1,65,48,2093,1993,40,0,23,1,7,29,143,61,3,2,0,0,58,19
250092604022,2893,2686,35,7,96,0,12,57,2825,2650,33,3,96,0,2,41,68,36,2,4,0,0,10,16
250092604023,1082,970,26,0,19,0,39,28,993,933,24,0,19,0,3,14,89,37,2,0,0,0,36,14
250092605001,1697,1567,27,6,20,0,41,36,1606,1543,22,4,20,0,0,17,91,24,5,2,0,0,41,19
250092605002,1289,1170,27,1,17,2,43,29,1177,1115,22,0,16,2,4,18,112,55,5,1,1,0,39,11
250092605003,802,756,13,1,4,0,15,13,766,743,7,1,4,0,0,11,36,13,6,0,0,0,15,2
250092606001,1119,1000,26,0,21,0,38,34,1000,929,21,0,21,0,2,27,119,71,5,0,0,0,36,7
250092606002,1110,954,32,4,34,0,53,33,913,839,21,4,34,0,2,13,197,115,11,0,0,0,51,20
250092606003,1148,811,66,4,21,1,197,48,670,587,29,4,21,1,9,19,478,224,37,0,0,0,188,29
250092607001,2219,1836,102,10,46,0,146,79,1757,1574,82,5,46,0,8,42,462,262,20,5,0,0,138,37
250092607002,2279,2004,56,0,45,0,107,67,2027,1889,48,0,45,0,4,41,252,115,8,0,0,0,103,26
250092608001,2320,1518,153,11,24,3,459,152,1427,1224,103,1,24,0,3,72,893,294,50,10,0,3,456,80
250092608002,2311,1552,182,25,14,1,440,97,1405,1193,142,11,14,1,5,39,906,359,40,14,0,0,435,58
250092609001,855,820,8,0,17,0,5,5,836,806,8,0,17,0,0,5,19,14,0,0,0,0,5,0
250092609002,1281,928,72,13,20,0,200,48,889,804,37,5,15,0,10,18,392,124,35,8,5,0,190,30
250092609003,1032,728,53,6,13,0,180,52,668,591,37,2,13,0,4,21,364,137,16,4,0,0,176,31
250092609004,1921,1561,59,10,53,0,175,63,1548,1415,36,3,53,0,5,36,373,146,23,7,0,0,170,27
250092610001,1030,942,34,1,4,0,35,14,932,898,23,0,3,0,0,8,98,44,11,1,1,0,35,6
250092610002,1781,1592,43,6,18,0,83,39,1593,1507,37,2,18,0,6,23,188,85,6,4,0,0,77,16
250092610003,1131,1028,42,1,18,0,29,13,1054,987,36,1,18,0,1,11,77,41,6,0,0,0,28,2
250092611011,1481,1422,13,0,16,1,5,24,1446,1398,12,0,15,1,1,19,35,24,1,0,1,0,4,5
250092611012,1381,1324,22,1,18,0,7,9,1325,1278,21,1,17,0,0,8,56,46,1,0,1,0,7,1
250092611013,1920,1827,20,6,33,0,11,23,1875,1802,19,3,33,0,2,16,45,25,1,3,0,0,9,7
250092611021,834,771,15,0,26,1,4,17,800,744,14,0,26,1,1,14,34,27,1,0,0,0,3,3
250092611022,1341,1219,35,1,37,0,28,21,1273,1188,29,1,37,0,2,16,68,31,6,0,0,0,26,5
250092611023,2783,2367,152,4,54,0,135,71,2423,2207,115,2,53,0,6,40,360,160,37,2,1,0,129,31
250092621001,961,937,12,0,5,0,2,5,941,919,11,0,5,0,1,5,20,18,1,0,0,0,1,0
250092621002,2875,2799,10,4,21,0,7,34,2839,2777,9,3,21,0,0,29,36,22,1,1,0,0,7,5
250092621003,2502,2413,18,6,15,0,12,38,2443,2371,16,5,15,0,2,34,59,42,2,1,0,0,10,4
250092631001,1526,1500,1,2,11,0,3,9,1496,1475,0,1,11,0,3,6,30,25,1,1,0,0,0,3
250092631002,938,911,3,1,6,0,2,15,932,911,2,1,6,0,0,12,6,0,1,0,0,0,2,3
250092631003,1771,1716,2,1,27,0,1,24,1741,1693,2,1,27,0,0,18,30,23,0,0,0,0,1,6
250092641001,2039,1977,13,2,25,2,0,20,2002,1948,10,1,25,2,0,16,37,29,3,1,0,0,0,4
250092641002,1819,1765,7,1,20,0,11,15,1798,1754,7,1,20,0,1,15,21,11,0,0,0,0,10,0
250092641003,2601,2548,11,2,14,0,6,20,2574,2528,11,1,14,0,3,17,27,20,0,1,0,0,3,3
250092651011,757,726,11,1,2,0,5,12,744,718,11,1,2,0,3,9,13,8,0,0,0,0,2,3
250092651012,815,788,1,0,4,0,10,12,794,780,1,0,4,0,0,9,21,8,0,0,0,0,10,3
250092651013,993,964,3,1,11,0,0,14,980,953,3,1,11,0,0,12,13,11,0,0,0,0,0,2
250092651014,1080,1039,2,8,18,0,0,13,1062,1027,2,3,18,0,0,12,18,12,0,5,0,0,0,1
250092651021,1425,1404,5,0,5,0,2,9,1407,1389,5,0,4,0,0,9,18,15,0,0,1,0,2,0
250092651022,3113,3006,16,4,37,0,11,39,3053,2965,15,2,37,0,1,33,60,41,1,2,0,0,10,6
250092661001,854,832,2,4,2,0,3,11,835,818,2,2,2,0,0,11,19,14,0,2,0,0,3,0
250092661002,734,714,8,0,2,0,1,9,725,707,7,0,2,0,0,9,9,7,1,0,0,0,1,0
250092661003,812,778,9,1,2,4,5,13,805,776,9,1,2,4,0,13,7,2,0,0,0,0,5,0
250092661004,918,888,2,3,1,2,9,13,894,876,2,3,1,2,2,8,24,12,0,0,0,0,7,5
250092661005,714,694,8,2,5,0,2,3,703,684,8,1,5,0,2,3,11,10,0,1,0,0,0,0
250092662001,1983,1838,26,9,35,0,24,51,1912,1793,23,6,35,0,12,43,71,45,3,3,0,0,12,8
250092662002,1925,1866,12,5,9,0,12,21,1901,1845,12,5,9,0,9,21,24,21,0,0,0,0,3,0
250092662003,1286,1259,9,2,5,0,1,10,1270,1243,9,2,5,0,1,10,16,16,0,0,0,0,0,0
250092663001,704,677,2,0,12,0,1,12,694,668,2,0,12,0,0,12,10,9,0,0,0,0,1,0
250092663002,1179,1149,5,3,2,0,4,16,1157,1135,4,3,2,0,0,13,22,14,1,0,0,0,4,3
250092663003,1826,1760,14,2,13,1,8,28,1789,1738,12,1,13,0,3,22,37,22,2,1,0,1,5,6
250092664001,817,780,9,1,6,0,2,19,802,776,5,1,6,0,0,14,15,4,4,0,0,0,2,5
250092664002,801,790,2,1,1,0,5,2,790,780,2,1,1,0,4,2,11,10,0,0,0,0,1,0
250092664003,973,913,12,4,8,0,13,23,949,900,11,4,8,0,3,23,24,13,1,0,0,0,10,0
250092664004,757,750,0,0,3,0,2,2,747,740,0,0,3,0,2,2,10,10,0,0,0,0,0,0
250092671011,718,700,7,3,0,0,0,8,703,688,7,2,0,0,0,6,15,12,0,1,0,0,0,2
250092671012,1040,1016,6,1,1,0,6,10,1019,1000,4,1,1,0,5,8,21,16,2,0,0,0,1,2
250092671013,1815,1756,8,3,27,1,3,17,1795,1740,8,3,27,1,0,16,20,16,0,0,0,0,3,1
250092671021,1296,1231,5,2,14,0,11,33,1276,1217,4,2,14,0,8,31,20,14,1,0,0,0,3,2
250092671022,1529,1452,7,6,37,0,6,21,1509,1440,7,6,37,0,0,19,20,12,0,0,0,0,6,2
250092671023,1124,1085,3,2,4,0,2,28,1097,1063,3,2,3,0,1,25,27,22,0,0,1,0,1,3
250092671024,761,738,2,2,15,0,2,2,756,736,2,2,15,0,0,1,5,2,0,0,0,0,2,1
250092681001,798,768,1,0,14,0,0,15,781,752,1,0,14,0,0,14,17,16,0,0,0,0,0,1
250092681002,1870,1823,12,4,17,0,6,8,1836,1798,12,0,17,0,2,7,34,25,0,4,0,0,4,1
250092682001,1299,1263,4,3,11,0,6,12,1282,1252,4,3,11,0,3,9,17,11,0,0,0,0,3,3
250092682002,957,917,1,0,20,0,1,18,945,910,1,0,20,0,0,14,12,7,0,0,0,0,1,4
250092682003,1732,1621,23,4,22,1,19,42,1698,1601,22,3,22,1,11,38,34,20,1,1,0,0,8,4
250092682004,2334,2246,9,2,30,0,17,30,2290,2212,7,1,29,0,12,29,44,34,2,1,1,0,5,1
250092683001,1186,1123,15,2,17,0,15,14,1161,1107,15,2,17,0,7,13,25,16,0,0,0,0,8,1
250092683002,1523,1476,6,3,14,0,4,20,1500,1459,6,2,14,0,2,17,23,17,0,1,0,0,2,3
250092683003,807,785,2,1,10,0,2,7,796,778,2,1,10,0,0,5,11,7,0,0,0,0,2,2
250092683004,610,588,0,3,4,0,9,6,601,581,0,3,4,0,7,6,9,7,0,0,0,0,2,0
250092684001,650,636,2,1,4,0,2,5,643,631,2,1,4,0,0,5,7,5,0,0,0,0,2,0
250092684002,1102,1071,7,0,8,0,3,13,1086,1056,7,0,8,0,2,13,16,15,0,0,0,0,1,0
250092684003,1093,1059,4,0,12,0,2,16,1073,1041,4,0,12,0,0,16,20,18,0,0,0,0,2,0
250092684004,1455,1412,12,1,12,0,7,11,1433,1396,12,1,12,0,2,10,22,16,0,0,0,0,5,1
250092691001,921,905,2,2,3,0,3,6,913,901,1,2,3,0,1,5,8,4,1,0,0,0,2,1
250092691002,1099,1077,3,0,7,0,0,12,1093,1072,3,0,6,0,0,12,6,5,0,0,1,0,0,0
250092691003,1146,1112,4,1,10,0,4,15,1134,1100,4,1,10,0,4,15,12,12,0,0,0,0,0,0
250092691004,2446,2398,3,7,17,0,7,14,2418,2376,3,7,17,0,1,14,28,22,0,0,0,0,6,0
250092691005,1054,1031,5,0,7,0,0,11,1041,1019,4,0,7,0,0,11,13,12,1,0,0,0,0,0
250092701001,2832,2761,9,0,24,3,12,23,2808,2742,9,0,24,3,8,22,24,19,0,0,0,0,4,1
250092701002,3024,2944,8,1,36,1,10,24,2989,2918,7,1,36,1,5,21,35,26,1,0,0,0,5,3
250099901000,0,0,0,0,0,0,0,0,0,0,0,0,0,0,0,0,0,0,0,0,0,0,0,0
250110401001,1220,1171,8,6,9,0,2,24,1207,1164,5,4,9,0,1,24,13,7,3,2,0,0,1,0
250110401002,1182,1149,5,1,4,0,3,20,1167,1137,5,1,4,0,2,18,15,12,0,0,0,0,1,2
250110401003,1195,1151,6,1,9,0,3,25,1187,1144,5,1,9,0,3,25,8,7,1,0,0,0,0,0
250110401004,897,869,2,4,9,0,3,10,886,862,2,3,9,0,0,10,11,7,0,1,0,0,3,0
250110402001,1822,1785,3,3,15,0,2,14,1806,1775,3,2,15,0,0,11,16,10,0,1,0,0,2,3
250110402002,1018,991,1,1,3,0,5,17,1009,988,1,1,3,0,0,16,9,3,0,0,0,0,5,1
250110402003,1500,1449,13,3,19,0,2,14,1488,1439,13,3,19,0,0,14,12,10,0,0,0,0,2,0
250110403001,1338,1307,3,1,5,0,6,16,1318,1300,3,0,5,0,0,10,20,7,0,1,0,0,6,6
250110403002,1694,1637,10,5,4,0,12,26,1658,1615,10,5,3,0,1,24,36,22,0,0,1,0,11,2
250110404001,971,951,0,4,7,0,0,9,962,942,0,4,7,0,0,9,9,9,0,0,0,0,0,0
250110404002,1609,1561,5,5,4,0,7,27,1578,1540,5,5,4,0,1,23,31,21,0,0,0,0,6,4
250110404003,848,807,16,7,6,0,4,8,828,804,10,3,6,0,1,4,20,3,6,4,0,0,3,4
250110405011,742,713,10,1,0,0,9,9,727,704,10,1,0,0,3,9,15,9,0,0,0,0,6,0
250110405012,1248,1176,19,4,1,0,23,25,1182,1133,16,4,1,0,5,23,66,43,3,0,0,0,18,2
250110405013,853,819,9,5,5,0,10,5,819,798,8,4,5,0,0,4,34,21,1,1,0,0,10,1
250110405014,1421,1358,17,2,9,1,2,32,1390,1337,16,2,9,1,0,25,31,21,1,0,0,0,2,7
250110405021,613,583,5,1,4,0,0,20,605,576,5,1,4,0,0,19,8,7,0,0,0,0,0,1
250110405022,1393,1320,7,9,22,0,10,25,1355,1292,7,8,22,0,5,21,38,28,0,1,0,0,5,4
250110405023,1569,1492,14,9,33,0,2,19,1539,1469,13,9,33,0,1,14,30,23,1,0,0,0,1,5
250110406001,1851,1722,22,3,30,0,9,65,1812,1690,22,3,29,0,5,63,39,32,0,0,1,0,4,2
250110406002,1771,1634,37,10,19,0,8,63,1716,1595,37,7,19,0,3,55,55,39,0,3,0,0,5,8
250110406003,990,950,2,2,21,0,5,10,980,944,1,2,21,0,2,10,10,6,1,0,0,0,3,0
250110407011,1029,927,26,1,12,0,16,47,958,879,22,1,12,0,0,44,71,48,4,0,0,0,16,3
250110407012,1229,1067,25,11,9,1,62,54,1094,1015,24,6,9,0,2,38,135,52,1,5,0,1,60,16
250110407013,1062,999,9,2,7,0,20,25,1025,986,6,2,7,0,2,22,37,13,3,0,0,0,18,3
250110407014,893,805,14,4,1,0,37,32,790,755,7,0,1,0,3,24,103,50,7,4,0,0,34,8
250110407021,893,879,7,1,2,1,0,3,889,876,6,1,2,1,0,3,4,3,1,0,0,0,0,0
250110407022,1251,1177,6,3,10,0,16,39,1216,1169,4,3,10,0,0,30,35,8,2,0,0,0,16,9
250110407023,701,668,5,2,6,0,10,10,678,651,4,1,6,0,6,10,23,17,1,1,0,0,4,0
250110407024,1379,1301,9,1,20,0,16,32,1349,1290,8,1,20,0,4,26,30,11,1,0,0,0,12,6
250110408001,1496,1457,12,0,6,1,6,14,1470,1440,12,0,6,1,0,11,26,17,0,0,0,0,6,3
250110408002,745,620,26,5,46,0,13,35,701,602,24,3,46,0,1,25,44,18,2,2,0,0,12,10
250110408003,1622,1446,44,5,68,1,29,29,1557,1415,38,5,68,1,8,22,65,31,6,0,0,0,21,7
250110408004,1317,1142,36,5,76,0,22,36,1245,1101,31,4,76,0,2,31,72,41,5,1,0,0,20,5
250110409001,1073,1004,16,0,19,1,1,32,1046,980,15,0,19,1,0,31,27,24,1,0,0,0,1,1
250110409002,2207,2116,12,1,38,0,8,32,2163,2084,11,0,38,0,0,30,44,32,1,1,0,0,8,2
250110409003,1267,1200,5,2,27,0,12,21,1226,1180,4,1,26,0,3,12,41,20,1,1,1,0,9,9
250110409004,578,547,8,0,14,0,4,5,558,537,4,0,13,0,0,4,20,10,4,0,1,0,4,1
250110410001,941,909,6,0,12,0,2,12,928,903,4,0,10,0,0,11,13,6,2,0,2,0,2,1
250110410002,1332,1174,38,5,9,0,46,60,1195,1108,27,4,9,0,5,42,137,66,11,1,0,0,41,18
250110410003,998,959,9,1,9,0,4,16,981,947,8,1,9,0,1,15,17,12,1,0,0,0,3,1
250110411001,771,730,2,0,16,0,10,13,749,722,2,0,16,0,3,6,22,8,0,0,0,0,7,7
250110411002,1049,1019,10,2,7,0,5,6,1038,1012,10,2,7,0,2,5,11,7,0,0,0,0,3,1
250110411003,820,786,11,0,6,0,3,14,801,776,10,0,6,0,0,9,19,10,1,0,0,0,3,5
250110411004,963,923,3,5,7,0,4,21,933,900,3,4,7,0,2,17,30,23,0,1,0,0,2,4
250110412001,1372,1286,8,8,22,0,22,26,1316,1261,7,7,22,0,0,19,56,25,1,1,0,0,22,7
250110412002,767,709,16,1,8,0,10,23,752,704,16,1,8,0,1,22,15,5,0,0,0,0,9,1
250110412003,1017,965,16,2,7,0,15,12,973,941,14,2,7,0,2,7,44,24,2,0,0,0,13,5
250110413001,870,766,25,11,21,0,13,34,829,740,23,11,21,0,4,30,41,26,2,0,0,0,9,4
250110413002,879,798,15,7,15,0,18,26,814,757,12,7,15,0,2,21,65,41,3,0,0,0,16,5
250110413003,846,764,13,6,18,0,21,24,795,737,12,4,17,0,4,21,51,27,1,2,1,0,17,3
250110413004,1002,927,10,1,28,1,9,26,970,907,10,1,28,1,0,23,32,20,0,0,0,0,9,3
250110413005,1045,983,15,2,8,0,15,22,992,951,12,2,8,0,3,16,53,32,3,0,0,0,12,6
250110414001,1391,1147,79,3,17,4,78,63,1192,1062,71,1,17,1,2,38,199,85,8,2,0,3,76,25
250110414002,1393,1278,21,7,29,0,9,49,1345,1247,21,5,29,0,1,42,48,31,0,2,0,0,8,7
250110415011,1083,1042,3,6,6,0,1,25,1066,1026,3,6,6,0,1,24,17,16,0,0,0,0,0,1
250110415012,654,633,4,3,3,0,0,11,640,624,3,2,3,0,0,8,14,9,1,1,0,0,0,3
250110415013,1897,1832,3,7,11,2,3,39,1869,1809,3,7,11,2,1,36,28,23,0,0,0,0,2,3
250110415021,1079,1046,8,2,4,0,2,17,1075,1045,8,2,4,0,0,16,4,1,0,0,0,0,2,1
250110415022,965,942,1,2,5,0,1,14,959,937,1,2,5,0,1,13,6,5,0,0,0,0,0,1
250110415023,937,905,4,2,8,0,3,15,918,892,4,2,8,0,0,12,19,13,0,0,0,0,3,3
250110415024,814,766,2,1,20,0,0,25,808,762,2,1,19,0,0,24,6,4,0,0,1,0,0,1
250138001011,1275,822,194,14,22,0,152,71,900,683,171,7,20,0,0,19,375,139,23,7,2,0,152,52
250138001012,1445,634,303,5,22,0,410,71,733,411,262,0,22,0,1,37,712,223,41,5,0,0,409,34
250138001013,1332,996,191,0,23,1,78,43,1130,896,181,0,23,1,0,29,202,100,10,0,0,0,78,14
250138001021,1906,1198,325,14,17,1,235,116,1151,776,288,5,15,1,4,62,755,422,37,9,2,0,231,54
250138001022,821,493,155,2,20,0,105,46,474,297,136,0,20,0,4,17,347,196,19,2,0,0,101,29
250138001023,1392,847,250,4,21,2,188,80,935,646,231,3,21,2,0,32,457,201,19,1,0,0,188,48
250138002011,1456,614,171,23,41,0,495,112,566,350,131,8,39,0,2,36,890,264,40,15,2,0,493,76
250138002012,1536,1144,179,1,5,0,144,63,1165,957,162,0,5,0,1,40,371,187,17,1,0,0,143,23
250138002013,659,340,100,8,31,1,140,39,367,238,78,2,31,0,3,15,292,102,22,6,0,1,137,24
250138002014,1156,791,158,7,21,0,113,66,783,590,138,1,21,0,4,29,373,201,20,6,0,0,109,37
250138002015,1527,1106,181,8,17,0,171,44,1111,915,150,5,17,0,5,19,416,191,31,3,0,0,166,25
250138002021,1333,960,170,3,24,2,123,51,974,776,144,2,23,2,0,27,359,184,26,1,1,0,123,24
250138003001,1252,753,161,6,16,0,256,60,768,576,142,0,16,0,3,31,484,177,19,6,0,0,253,29
250138003002,1152,725,125,7,13,0,230,52,677,525,113,0,13,0,0,26,475,200,12,7,0,0,230,26
250138003003,1068,590,162,6,16,0,250,44,601,422,143,3,12,0,2,19,467,168,19,3,4,0,248,25
250138003004,923,672,89,6,9,0,103,44,628,520,75,3,9,0,0,21,295,152,14,3,0,0,103,23
250138004001,1732,825,227,22,21,2,525,110,630,364,193,8,21,0,4,40,1102,461,34,14,0,2,521,70
250138004002,1405,851,188,0,41,0,249,76,759,557,139,0,41,0,0,22,646,294,49,0,0,0,249,54
250138004003,799,395,103,10,8,0,227,56,313,200,87,0,8,0,0,18,486,195,16,10,0,0,227,38
250138004004,1532,986,161,12,7,1,269,96,918,757,120,3,3,0,2,33,614,229,41,9,4,1,267,63
250138004005,1258,703,184,15,11,4,304,37,708,519,160,0,11,4,3,11,550,184,24,15,0,0,301,26
250138005001,1331,617,166,19,20,0,426,83,479,328,116,2,17,0,2,14,852,289,50,17,3,0,424,69
250138005002,1031,369,142,3,2,0,457,58,188,77,102,1,2,0,2,4,843,292,40,2,0,0,455,54
250138005003,1004,692,104,1,39,0,138,30,737,591,93,0,37,0,7,9,267,101,11,1,2,0,131,21
250138006001,902,339,105,3,6,0,401,48,115,44,38,1,2,0,9,21,787,295,67,2,4,0,392,27
250138006002,1029,373,56,6,5,9,462,118,86,33,37,0,5,0,0,11,943,340,19,6,0,9,462,107
250138006003,689,232,47,22,2,0,335,51,50,28,10,1,2,0,0,9,639,204,37,21,0,0,335,42
250138007001,1547,578,170,4,5,0,693,97,139,58,67,0,5,0,0,9,1408,520,103,4,0,0,693,88
250138007002,2453,898,354,22,12,0,1027,140,360,106,225,6,12,0,0,11,2093,792,129,16,0,0,1027,129
250138008001,1278,632,212,2,1,2,380,49,341,174,158,1,1,0,0,7,937,458,54,1,0,2,380,42
250138008002,820,354,85,19,5,3,299,55,56,9,37,2,3,0,1,4,764,345,48,17,2,3,298,51
250138009001,1504,637,271,19,5,3,478,91,411,169,204,0,5,0,4,29,1093,468,67,19,0,3,474,62
250138009002,1394,717,229,18,16,0,376,38,498,285,186,4,14,0,1,8,896,432,43,14,2,0,375,30
250138009003,1238,495,200,8,20,4,448,63,255,69,144,0,20,0,10,12,983,426,56,8,0,4,438,51
250138011011,1862,779,334,14,44,1,587,103,639,301,255,4,43,0,2,34,1223,478,79,10,1,1,585,69
250138011021,891,434,209,8,31,2,177,30,554,316,187,4,30,0,1,16,337,118,22,4,1,2,176,14
250138011022,646,366,92,4,1,1,155,27,380,275,84,3,1,1,0,16,266,91,8,1,0,0,155,11
250138012001,885,285,208,11,0,0,342,39,208,48,152,0,0,0,0,8,677,237,56,11,0,0,342,31
250138012002,1113,467,257,9,13,0,296,71,461,194,226,1,13,0,1,26,652,273,31,8,0,0,295,45
250138012003,640,317,167,11,4,0,117,24,387,224,148,3,4,0,0,8,253,93,19,8,0,0,117,16
250138013001,1195,305,643,9,10,1,154,73,737,102,589,8,7,0,0,31,458,203,54,1,3,1,154,42
250138013002,1155,265,571,8,0,4,229,78,640,70,530,0,0,4,0,36,515,195,41,8,0,0,229,42
250138013003,1408,527,534,16,10,0,235,86,801,284,474,1,7,0,2,33,607,243,60,15,3,0,233,53
250138013004,878,277,485,7,5,0,48,56,686,189,450,6,5,0,1,35,192,88,35,1,0,0,47,21
250138014011,1972,375,938,14,10,6,537,92,974,87,853,2,5,0,1,26,998,288,85,12,5,6,536,66
250138014012,2020,542,974,27,11,0,379,87,1281,283,916,4,11,0,1,66,739,259,58,23,0,0,378,21
250138014021,1078,371,433,5,38,0,179,52,684,228,396,2,37,0,0,21,394,143,37,3,1,0,179,31
250138014022,938,435,316,3,50,1,82,51,691,310,292,3,50,0,0,36,247,125,24,0,0,1,82,15
250138015011,1960,873,697,35,36,2,206,111,1480,725,643,21,28,0,1,62,480,148,54,14,8,2,205,49
250138015012,826,396,257,5,14,1,111,42,605,333,236,1,11,1,2,21,221,63,21,4,3,0,109,21
250138015013,1301,542,431,11,18,0,249,50,803,346,405,3,18,0,0,31,498,196,26,8,0,0,249,19
250138015014,1274,523,513,1,10,0,163,64,888,353,485,0,10,0,3,37,386,170,28,1,0,0,160,27
250138015021,1224,624,318,0,26,0,176,80,807,432,305,0,25,0,0,45,417,192,13,0,1,0,176,35
250138015022,761,366,225,3,5,0,123,39,513,268,217,3,5,0,0,20,248,98,8,0,0,0,123,19
250138015023,1427,391,517,15,5,0,363,136,807,234,478,9,3,0,0,83,620,157,39,6,2,0,363,53
250138015031,1096,538,298,3,35,1,156,65,762,425,270,3,35,1,2,26,334,113,28,0,0,0,154,39
250138015032,2125,1223,479,17,33,0,291,82,1462,959,406,9,33,0,7,48,663,264,73,8,0,0,284,34
250138015033,815,403,205,2,22,0,130,53,517,288,191,0,22,0,1,15,298,115,14,2,0,0,129,38
250138016011,2398,2000,245,3,44,1,58,47,2222,1914,217,1,44,1,5,40,176,86,28,2,0,0,53,7
250138016012,666,464,121,2,10,1,48,20,549,407,111,1,10,1,8,11,117,57,10,1,0,0,40,9
250138016013,1023,556,330,10,42,0,42,43,869,465,316,10,42,0,2,34,154,91,14,0,0,0,40,9
250138016014,980,497,338,6,19,0,54,66,821,431,331,5,19,0,1,34,159,66,7,1,0,0,53,32
250138016021,2789,1553,718,16,45,3,335,119,2000,1251,631,3,34,3,2,76,789,302,87,13,11,0,333,43
250138016022,893,696,142,1,6,1,25,22,799,630,142,1,6,1,2,17,94,66,0,0,0,0,23,5
250138016023,1426,1205,140,4,32,3,18,24,1336,1141,133,4,32,0,3,23,90,64,7,0,0,3,15,1
250138016031,1522,837,390,12,59,0,160,64,1111,665,350,2,57,0,0,37,411,172,40,10,2,0,160,27
250138016032,2663,2077,332,9,68,2,82,93,2395,1939,306,3,67,2,7,71,268,138,26,6,1,0,75,22
250138016041,2635,2170,281,7,71,0,42,64,2444,2052,262,7,71,0,4,48,191,118,19,0,0,0,38,16
250138016042,1132,939,131,3,11,0,19,29,974,827,112,3,10,0,2,20,158,112,19,0,1,0,17,9
250138016051,1043,790,178,0,29,7,25,14,951,739,169,0,29,0,3,11,92,51,9,0,0,7,22,3
250138016052,2917,1634,793,14,71,7,236,162,2128,1264,682,4,71,4,7,96,789,370,111,10,0,3,229,66
250138016053,648,488,101,0,26,0,18,15,564,449,77,0,26,0,0,12,84,39,24,0,0,0,18,3
250138017001,1129,301,630,7,26,6,93,66,861,208,582,1,26,0,0,44,268,93,48,6,0,6,93,22
250138017002,1654,1415,165,1,8,1,23,41,1574,1379,154,1,8,1,1,30,80,36,11,0,0,0,22,11
250138017003,927,176,564,15,3,8,106,55,625,62,523,4,3,1,0,32,302,114,41,11,0,7,106,23
250138017004,1472,342,953,5,12,2,98,60,1205,223,925,1,11,2,6,37,267,119,28,4,1,0,92,23
250138017005,1364,166,879,4,9,1,257,48,909,53,816,3,9,1,2,25,455,113,63,1,0,0,255,23
250138017006,1031,209,536,4,8,0,225,49,563,38,503,3,8,0,0,11,468,171,33,1,0,0,225,38
250138018001,740,206,276,7,1,0,224,26,289,48,235,0,1,0,2,3,451,158,41,7,0,0,222,23
250138018002,1038,183,504,8,0,0,295,48,494,17,445,8,0,0,1,23,544,166,59,0,0,0,294,25
250138018003,994,365,426,3,12,0,149,39,691,260,398,2,5,0,1,25,303,105,28,1,7,0,148,14
250138018004,712,166,289,8,3,0,193,53,314,18,262,1,3,0,5,25,398,148,27,7,0,0,188,28
250138018005,795,100,429,0,3,0,235,28,462,34,405,0,0,0,4,19,333,66,24,0,3,0,231,9
250138019011,1263,522,307,14,48,2,294,76,564,195,271,5,48,2,4,39,699,327,36,9,0,0,290,37
250138019012,2675,797,843,30,8,0,858,139,1018,279,684,13,4,0,2,36,1657,518,159,17,4,0,856,103
250138019021,1634,695,288,40,7,0,502,102,527,280,212,10,4,0,4,17,1107,415,76,30,3,0,498,85
250092106004,623,585,4,0,9,0,9,16,598,574,3,0,9,0,0,12,25,11,1,0,0,0,9,4
250092107001,1247,940,81,8,25,0,154,39,969,834,51,2,25,0,37,20,278,106,30,6,0,0,117,19
250092107002,865,550,48,0,11,0,221,35,609,465,39,0,11,0,73,21,256,85,9,0,0,0,148,14
250092107003,1199,974,44,0,13,0,133,35,1037,905,24,0,13,0,70,25,162,69,20,0,0,0,63,10
250092107004,690,618,10,3,34,0,10,15,639,578,9,1,34,0,4,13,51,40,1,2,0,0,6,2
250092108001,1337,1064,43,5,11,0,171,43,1175,1008,32,1,11,0,97,26,162,56,11,4,0,0,74,17
250092108002,1111,862,58,5,21,0,129,36,898,780,38,1,21,0,31,27,213,82,20,4,0,0,98,9
250092108003,2121,1709,79,5,35,0,239,54,1757,1584,57,0,35,0,55,26,364,125,22,5,0,0,184,28
250092109001,1192,1060,20,0,4,0,85,23,1126,1044,20,0,4,0,41,17,66,16,0,0,0,0,44,6
250092109002,878,838,11,4,6,0,5,14,851,819,9,4,6,0,2,11,27,19,2,0,0,0,3,3
250092109003,1813,1659,28,2,13,0,58,53,1695,1607,24,2,13,0,11,38,118,52,4,0,0,0,47,15
250092111001,897,854,15,0,10,0,7,11,871,837,15,0,10,0,0,9,26,17,0,0,0,0,7,2
250092111002,1202,1173,11,0,3,0,5,10,1191,1166,11,0,3,0,1,10,11,7,0,0,0,0,4,0
250092111003,912,875,9,1,16,0,7,4,880,850,9,1,16,0,0,4,32,25,0,0,0,0,7,0
250092111004,783,720,18,0,21,0,9,15,766,708,17,0,20,0,6,15,17,12,1,0,1,0,3,0
250092112001,1031,983,9,1,17,0,0,21,1002,959,6,1,17,0,0,19,29,24,3,0,0,0,0,2
250092112002,1479,1416,22,4,9,0,14,14,1445,1397,21,4,8,0,1,14,34,19,1,0,1,0,13,0
250092112003,1626,1569,8,2,22,0,5,20,1599,1555,3,2,22,0,1,16,27,14,5,0,0,0,4,4
250092112004,1964,1861,15,6,35,1,21,25,1910,1835,15,2,35,1,4,18,54,26,0,4,0,0,17,7
250092113001,2157,2063,12,1,57,0,11,13,2111,2032,9,1,57,0,0,12,46,31,3,0,0,0,11,1
250092113002,1536,1491,8,0,28,0,1,8,1519,1477,7,0,28,0,0,7,17,14,1,0,0,0,1,1
250092113003,3274,3147,13,1,83,0,13,17,3224,3119,11,1,83,0,1,9,50,28,2,0,0,0,12,8
250092114011,3560,3273,75,3,112,3,34,60,3424,3181,66,3,112,3,10,49,136,92,9,0,0,0,24,11
250092114021,1249,1222,2,1,20,0,0,4,1232,1205,2,1,20,0,0,4,17,17,0,0,0,0,0,0
250092114022,1749,1623,33,2,45,0,30,16,1699,1602,31,1,45,0,6,14,50,21,2,1,0,0,24,2
250092114023,2032,1938,26,8,8,0,20,32,1977,1913,24,7,8,0,3,22,55,25,2,1,0,0,17,10
250092114024,1042,1019,6,0,14,0,2,1,1025,1003,6,0,14,0,1,1,17,16,0,0,0,0,1,0
250092121001,1290,1222,2,1,31,0,11,23,1269,1214,2,1,31,0,3,18,21,8,0,0,0,0,8,5
250092121002,2233,2133,15,1,52,0,10,22,2201,2113,15,1,52,0,1,19,32,20,0,0,0,0,9,3
250092121003,2142,2052,10,1,40,0,4,35,2121,2032,10,1,40,0,3,35,21,20,0,0,0,0,1,0
250092121004,3322,2656,177,40,81,3,281,84,2756,2486,126,10,79,0,8,47,566,170,51,30,2,3,273,37
250092131001,1841,1763,5,2,43,0,4,24,1816,1744,5,1,43,0,0,23,25,19,0,1,0,0,4,1
250092131002,1357,1314,4,2,17,0,5,15,1340,1302,4,0,17,0,3,14,17,12,0,2,0,0,2,1
250092131003,1721,1670,7,1,20,0,8,15,1677,1636,6,1,20,0,1,13,44,34,1,0,0,0,7,2
250092131004,823,792,11,0,7,0,2,11,802,775,7,0,7,0,2,11,21,17,4,0,0,0,0,0
250092131005,2219,2142,10,0,36,0,2,29,2181,2113,10,0,36,0,1,21,38,29,0,0,0,0,1,8
250092141001,1572,1514,10,4,23,0,6,15,1549,1501,9,3,22,0,0,14,23,13,1,1,1,0,6,1
250092141002,1455,1415,5,0,14,0,0,21,1428,1396,3,0,14,0,0,15,27,19,2,0,0,0,0,6
250092141003,2196,2112,16,0,32,0,6,30,2153,2075,15,0,31,0,4,28,43,37,1,0,1,0,2,2
250092141004,866,848,4,1,8,0,5,0,847,830,4,1,8,0,4,0,19,18,0,0,0,0,1,0
250092151011,2055,2006,1,9,25,0,3,11,2044,1997,1,9,25,0,2,10,11,9,0,0,0,0,1,1
250092151012,2080,1684,31,5,331,0,5,24,2048,1662,29,3,331,0,1,22,32,22,2,2,0,0,4,2
250092151013,761,722,9,0,19,0,1,10,740,708,7,0,19,0,0,6,21,14,2,0,0,0,1,4
250092151021,570,554,0,0,10,0,0,6,562,549,0,0,7,0,0,6,8,5,0,0,3,0,0,0
250092151022,830,792,0,0,13,0,8,17,815,785,0,0,13,0,1,16,15,7,0,0,0,0,7,1
250092151023,881,848,4,0,20,0,4,5,851,821,4,0,20,0,1,5,30,27,0,0,0,0,3,0
250092151024,587,569,1,0,5,0,1,11,583,566,1,0,5,0,0,11,4,3,0,0,0,0,1,0
250092161001,1033,1024,0,2,3,0,1,3,1029,1021,0,2,3,0,0,3,4,3,0,0,0,0,1,0
250092161002,1699,1653,2,2,21,0,8,13,1677,1640,2,0,21,0,4,10,22,13,0,2,0,0,4,3
250092161003,2143,1994,28,2,58,4,30,27,2074,1946,27,2,58,4,12,25,69,48,1,0,0,0,18,2
250092171001,2704,2514,36,1,84,1,34,34,2618,2460,34,1,84,1,7,31,86,54,2,0,0,0,27,3
250092171002,2577,2499,13,1,32,0,4,28,2530,2461,13,1,32,0,4,19,47,38,0,0,0,0,0,9
250092171003,2010,1809,85,1,47,2,22,44,1906,1754,74,1,45,2,0,30,104,55,11,0,2,0,22,14
250092172011,1126,1093,12,0,13,1,4,3,1109,1078,12,0,13,1,2,3,17,15,0,0,0,0,2,0
250092172012,1039,1020,1,0,15,1,0,2,1032,1013,1,0,15,1,0,2,7,7,0,0,0,0,0,0
250092172013,2053,1824,67,2,44,0,64,52,1921,1762,66,0,43,0,9,41,132,62,1,2,1,0,55,11
250092172021,927,896,8,0,14,0,4,5,910,884,5,0,14,0,2,5,17,12,3,0,0,0,2,0
250092172022,785,756,3,0,14,0,3,9,784,755,3,0,14,0,3,9,1,1,0,0,0,0,0,0
250092172023,676,656,2,1,8,0,0,9,663,645,2,1,7,0,0,8,13,11,0,0,1,0,0,1
250092172024,1103,1071,3,0,13,0,3,13,1089,1061,0,0,13,0,2,13,14,10,3,0,0,0,1,0
250092173001,817,628,44,10,11,8,75,41,704,584,40,3,11,8,31,27,113,44,4,7,0,0,44,14
250092173002,993,844,45,1,33,0,35,35,925,816,44,1,32,0,5,27,68,28,1,0,1,0,30,8
250092173003,1164,1038,17,1,43,0,42,23,1084,996,12,1,43,0,20,12,80,42,5,0,0,0,22,11
250092173004,620,588,0,2,7,4,9,10,594,574,0,2,7,4,2,5,26,14,0,0,0,0,7,5
250092173005,910,763,42,6,8,1,56,34,795,717,31,6,8,1,6,26,115,46,11,0,0,0,50,8
250092174001,764,687,18,1,12,0,22,24,736,670,18,1,12,0,12,23,28,17,0,0,0,0,10,1
250092174002,1342,1188,52,0,45,1,32,24,1292,1154,50,0,45,1,19,23,50,34,2,0,0,0,13,1
250092174003,1230,1146,22,5,14,3,21,19,1184,1132,15,4,14,3,2,14,46,14,7,1,0,0,19,5
250092174004,1882,1630,69,5,48,0,62,68,1752,1564,60,4,47,0,22,55,130,66,9,1,1,0,40,13
250092175001,894,861,2,1,15,0,6,9,875,847,2,0,15,0,2,9,19,14,0,1,0,0,4,0
250092175002,1022,978,16,1,6,0,11,10,989,957,16,1,6,0,0,9,33,21,0,0,0,0,11,1
250092175003,1042,1008,3,0,11,0,3,17,1035,1002,3,0,11,0,3,16,7,6,0,0,0,0,0,1
250092175004,723,710,0,0,3,0,1,9,713,703,0,0,3,0,0,7,10,7,0,0,0,0,1,2
250092175005,1109,1040,17,5,9,0,20,18,1066,1016,15,4,6,0,9,16,43,24,2,1,3,0,11,2
250092175006,1311,1246,11,5,18,0,13,18,1267,1217,10,4,18,0,4,14,44,29,1,1,0,0,9,4
250092176001,2735,2633,12,2,50,0,17,21,2694,2616,11,2,50,0,1,14,41,17,1,0,0,0,16,7
250092176002,688,677,3,0,5,0,0,3,680,669,3,0,5,0,0,3,8,8,0,0,0,0,0,0
250092176003,1034,989,2,1,18,0,2,22,1025,985,2,1,18,0,0,19,9,4,0,0,0,0,2,3
250092176004,1790,1756,7,0,17,0,1,9,1764,1732,7,0,17,0,0,8,26,24,0,0,0,0,1,1
250092176005,2432,2320,35,10,29,1,18,19,2369,2281,35,4,29,1,8,11,63,39,0,6,0,0,10,8
250092181001,1226,1203,1,1,10,0,1,10,1206,1187,1,1,10,0,0,7,20,16,0,0,0,0,1,3
250092181002,752,729,1,0,10,0,1,11,732,713,1,0,9,0,0,9,20,16,0,0,1,0,1,2
250092181003,888,877,0,2,3,0,2,4,876,869,0,2,1,0,1,3,12,8,0,0,2,0,1,1
250092181004,1551,1494,5,3,19,0,1,29,1535,1481,4,3,19,0,0,28,16,13,1,0,0,0,1,1
250092181005,719,710,0,5,2,0,0,2,711,702,0,5,2,0,0,2,8,8,0,0,0,0,0,0
250092201011,688,676,0,0,7,0,1,4,683,673,0,0,7,0,0,3,5,3,0,0,0,0,1,1
250092201012,1151,1111,8,0,9,0,3,20,1121,1091,8,0,9,0,0,13,30,20,0,0,0,0,3,7
250092201013,888,867,9,0,5,0,1,6,878,861,8,0,5,0,0,4,10,6,1,0,0,0,1,2
250092201014,1276,1245,7,2,14,0,4,4,1260,1231,7,2,14,0,2,4,16,14,0,0,0,0,2,0
250092201021,2145,2084,8,3,14,2,8,26,2110,2055,8,2,14,2,6,23,35,29,0,1,0,0,2,3
250092201022,804,762,13,0,7,4,5,13,789,755,10,0,7,4,1,12,15,7,3,0,0,0,4,1
250092211001,1266,1240,5,1,2,0,10,8,1243,1228,4,1,2,0,1,7,23,12,1,0,0,0,9,1
250092211002,1495,1458,4,1,12,2,2,16,1470,1438,4,0,12,1,0,15,25,20,0,1,0,1,2,1
250092211003,1421,1390,6,0,5,0,5,15,1411,1383,4,0,5,0,4,15,10,7,2,0,0,0,1,0
250092213001,1514,1466,2,1,27,0,1,17,1492,1449,2,0,26,0,1,14,22,17,0,1,1,0,0,3
250092213002,945,918,7,1,8,0,0,11,932,905,7,1,8,0,0,11,13,13,0,0,0,0,0,0
250092213003,599,593,0,0,2,0,4,0,590,588,0,0,2,0,0,0,9,5,0,0,0,0,4,0
250092213004,1474,1439,1,1,18,0,3,12,1456,1424,0,1,18,0,3,10,18,15,1,0,0,0,0,2
250092214001,980,830,19,2,14,8,80,27,894,813,16,0,14,4,29,18,86,17,3,2,0,4,51,9
250092214002,1644,1553,19,0,9,1,43,19,1578,1524,10,0,9,1,19,15,66,29,9,0,0,0,24,4
250092214003,597,574,8,1,3,1,4,6,583,565,8,0,3,0,4,3,14,9,0,1,0,1,0,3
250092215001,1513,1433,14,4,26,0,12,24,1434,1365,13,4,26,0,10,16,79,68,1,0,0,0,2,8
250092215002,1410,1338,18,2,4,9,21,18,1343,1294,15,2,4,5,8,15,67,44,3,0,0,4,13,3
250092216001,802,685,38,2,2,0,36,39,695,636,29,0,2,0,3,25,107,49,9,2,0,0,33,14
250092216002,897,853,12,0,1,0,15,16,858,830,12,0,1,0,2,13,39,23,0,0,0,0,13,3
250092216003,749,720,2,1,7,1,1,17,738,717,2,1,7,1,0,10,11,3,0,0,0,0,1,7
250092217001,1035,958,13,2,19,4,23,16,1000,947,11,0,19,4,4,15,35,11,2,2,0,0,19,1
250092217002,1805,1716,17,4,15,0,24,29,1749,1688,17,3,14,0,4,23,56,28,0,1,1,0,20,6
250092218001,839,827,0,0,10,0,0,2,836,825,0,0,10,0,0,1,3,2,0,0,0,0,0,1
250092218002,934,912,3,0,8,0,0,11,930,908,3,0,8,0,0,11,4,4,0,0,0,0,0,0
250092219011,2506,2439,1,6,30,0,5,25,2482,2422,1,5,30,0,4,20,24,17,0,1,0,0,1,5
250092219012,913,903,3,2,2,0,0,3,898,891,1,2,2,0,0,2,15,12,2,0,0,0,0,1
250092219021,1474,1383,28,4,22,0,9,28,1442,1359,27,4,22,0,2,28,32,24,1,0,0,0,7,0
250092219022,1977,1920,19,5,12,0,4,17,1948,1901,13,5,12,0,1,16,29,19,6,0,0,0,3,1
250092221001,1049,1021,2,1,11,1,2,11,1029,1004,1,0,10,1,2,11,20,17,1,1,1,0,0,0
250092221002,1471,1435,5,2,9,0,5,15,1453,1422,5,0,9,0,2,15,18,13,0,2,0,0,3,0
250092221003,984,950,5,0,15,0,0,14,976,943,5,0,15,0,0,13,8,7,0,0,0,0,0,1
250092231001,1624,1554,11,2,19,0,7,31,1604,1540,10,2,19,0,4,29,20,14,1,0,0,0,3,2
250092231002,2256,2184,15,2,17,0,10,28,2219,2155,15,1,17,0,3,28,37,29,0,1,0,0,7,0
250092232001,1248,1175,7,0,18,5,16,27,1223,1164,5,0,18,5,9,22,25,11,2,0,0,0,7,5
250092232002,1504,1429,2,6,25,1,26,15,1461,1402,2,5,25,1,13,13,43,27,0,1,0,0,13,2
250092232003,988,959,8,0,9,0,3,9,977,949,8,0,9,0,3,8,11,10,0,0,0,0,0,1
250092233001,2081,1981,11,3,45,0,12,29,2049,1959,10,3,45,0,6,26,32,22,1,0,0,0,6,3
250092233002,2340,2266,8,6,25,0,12,23,2304,2238,8,1,25,0,10,22,36,28,0,5,0,0,2,1
250092233003,1134,1088,3,1,16,0,10,16,1106,1064,3,0,16,0,7,16,28,24,0,1,0,0,3,0
250092501001,2329,992,198,31,31,0,922,155,592,471,75,6,28,0,3,9,1737,521,123,25,3,0,919,146
250092502001,2179,919,171,37,30,0,916,106,592,472,58,8,26,0,6,22,1587,447,113,29,4,0,910,84
250092502002,1352,371,94,18,29,0,790,50,202,132,32,3,29,0,3,3,1150,239,62,15,0,0,787,47
250092502003,1048,493,40,14,15,0,416,70,339,285,10,9,15,0,2,18,709,208,30,5,0,0,414,52
250092502004,945,551,62,4,11,0,283,34,413,352,41,0,10,0,1,9,532,199,21,4,1,0,282,25
250092503001,2101,592,158,24,31,0,1124,172,227,137,43,6,30,0,5,6,1874,455,115,18,1,0,1119,166
250092504001,1288,401,119,18,7,3,602,138,131,92,26,2,0,0,3,8,1157,309,93,16,7,3,599,130
250092504002,1686,621,181,49,1,0,680,154,136,109,14,7,1,0,4,1,1550,512,167,42,0,0,676,153
250092504003,884,346,84,9,18,4,377,46,101,62,22,0,12,0,3,2,783,284,62,9,6,4,374,44
250092505001,1455,495,105,26,2,0,656,171,81,66,6,2,0,0,2,5,1374,429,99,24,2,0,654,166
250092505002,779,216,87,14,16,3,348,95,24,8,2,0,6,0,7,1,755,208,85,14,10,3,341,94
250092505003,1576,553,146,10,3,1,714,149,140,88,32,0,3,0,4,13,1436,465,114,10,0,1,710,136
250092506001,1429,541,110,12,11,11,585,159,308,259,28,4,8,0,2,7,1121,282,82,8,3,11,583,152
250092506002,1188,421,89,13,6,0,570,89,271,196,36,6,6,0,7,20,917,225,53,7,0,0,563,69
250092506003,1521,494,81,9,1,2,831,103,156,115,23,6,1,0,5,6,1365,379,58,3,0,2,826,97
250092506004,1461,465,193,8,19,0,636,140,213,169,24,2,13,0,0,5,1248,296,169,6,6,0,636,135
250092507001,2069,791,166,43,35,0,880,154,328,212,57,2,35,0,17,5,1741,579,109,41,0,0,863,149
250092507002,1072,386,63,4,7,4,510,98,131,118,8,0,3,0,1,1,941,268,55,4,4,4,509,97
250092507003,1615,511,158,8,5,0,777,156,207,149,39,8,4,0,3,4,1408,362,119,0,1,0,774,152
250092508001,1645,835,146,13,18,0,498,135,512,406,52,5,18,0,5,26,1133,429,94,8,0,0,493,109
250092508002,1811,914,149,31,30,3,586,98,426,351,35,2,23,1,5,9,1385,563,114,29,7,2,581,89
250092508003,1278,802,113,12,19,0,275,57,672,597,45,0,19,0,2,9,606,205,68,12,0,0,273,48
250092508004,1087,676,76,15,46,1,238,35,447,370,20,5,41,0,6,5,640,306,56,10,5,1,232,30
250092508005,1111,704,60,12,9,0,242,84,487,437,19,2,9,0,1,19,624,267,41,10,0,0,241,65
250092509001,1113,357,85,19,5,1,580,66,47,32,5,1,5,0,3,1,1066,325,80,18,0,1,577,65
250092509002,1080,347,133,19,1,2,456,122,106,69,21,2,0,1,10,3,974,278,112,17,1,1,446,119
250092510001,1782,655,155,30,16,0,824,102,270,208,37,1,12,0,5,7,1512,447,118,29,4,0,819,95
250092511001,1414,898,106,15,13,0,319,63,632,596,17,1,8,0,2,8,782,302,89,14,5,0,317,55
250092511002,1015,320,49,5,2,0,578,61,100,60,23,1,2,0,3,11,915,260,26,4,0,0,575,50
250092511003,508,190,29,15,7,0,228,39,53,39,4,1,4,0,5,0,455,151,25,14,3,0,223,39
250092512001,1357,512,125,49,6,2,591,72,188,147,27,0,5,0,6,3,1169,365,98,49,1,2,585,69
250092513001,2014,548,128,33,12,1,1084,208,137,83,35,4,5,0,3,7,1877,465,93,29,7,1,1081,201
250092513002,1041,362,74,5,42,0,516,42,129,72,18,1,34,0,2,2,912,290,56,4,8,0,514,40
250092513003,666,232,45,6,5,2,340,36,125,98,16,0,5,0,2,4,541,134,29,6,0,2,338,32
250092514001,2231,687,177,26,42,0,1109,190,273,150,45,4,30,0,16,28,1958,537,132,22,12,0,1093,162
250092514002,768,295,57,9,38,0,340,29,224,148,30,1,38,0,3,4,544,147,27,8,0,0,337,25
250092514003,927,401,54,12,34,0,371,55,214,152,26,0,30,0,5,1,713,249,28,12,4,0,366,54
250092514004,1127,604,91,8,14,0,360,50,446,354,56,8,14,0,8,6,681,250,35,0,0,0,352,44
250092515001,1070,454,71,15,74,0,381,75,330,241,10,0,72,0,4,3,740,213,61,15,2,0,377,72
250092515002,1120,459,76,4,43,0,460,78,331,248,28,0,43,0,1,11,789,211,48,4,0,0,459,67
250092515003,1615,735,148,27,76,0,531,98,508,356,52,1,75,0,5,19,1107,379,96,26,1,0,526,79
250092515004,928,506,60,4,65,3,238,52,413,327,12,0,65,0,3,6,515,179,48,4,0,3,235,46
250092515005,1416,553,129,24,40,7,565,98,275,188,37,1,38,0,5,6,1141,365,92,23,2,7,560,92
250092516001,1073,565,61,12,70,0,338,27,487,383,29,0,70,0,3,2,586,182,32,12,0,0,335,25
250092516002,2070,733,190,31,82,0,940,94,476,299,67,2,82,0,11,15,1594,434,123,29,0,0,929,79
250092516003,1718,745,134,21,96,0,616,106,443,289,48,0,92,0,5,9,1275,456,86,21,4,0,611,97
250092516004,1116,372,98,20,36,2,546,42,177,106,34,1,27,0,8,1,939,266,64,19,9,2,538,41
250092517001,1476,520,95,24,83,2,658,94,343,204,28,3,82,0,5,21,1133,316,67,21,1,2,653,73
250092517002,1542,1108,77,12,163,0,150,32,1186,976,32,3,159,0,4,12,356,132,45,9,4,0,146,20
250092517003,1277,435,67,16,19,2,670,68,177,121,22,1,17,0,2,14,1100,314,45,15,2,2,668,54
250092517004,850,335,87,9,92,0,283,44,303,166,32,0,91,0,5,9,547,169,55,9,1,0,278,35
250092518001,1322,809,59,12,83,0,332,27,808,674,34,2,80,0,3,15,514,135,25,10,3,0,329,12
250092518002,1489,799,98,9,74,0,444,65,643,520,36,3,73,0,0,11,846,279,62,6,1,0,444,54
250092518003,2202,1549,88,19,96,0,342,108,1526,1330,59,1,94,0,10,32,676,219,29,18,2,0,332,76
250092518004,2141,1529,93,13,66,1,372,67,1508,1348,55,2,64,0,9,30,633,181,38,11,2,1,363,37
250092521011,1334,1084,81,11,19,0,95,44,1083,1003,46,6,19,0,3,6,251,81,35,5,0,0,92,38
250092521012,730,542,40,3,42,0,66,37,549,462,31,0,42,0,0,14,181,80,9,3,0,0,66,23
250092521013,1445,1246,39,0,50,0,57,53,1295,1168,31,0,50,0,12,34,150,78,8,0,0,0,45,19
250092521021,1439,1345,4,0,44,0,32,14,1382,1319,2,0,44,0,4,13,57,26,2,0,0,0,28,1
250092521022,1479,1385,16,3,54,0,13,8,1443,1366,16,3,53,0,0,5,36,19,0,0,1,0,13,3
250092521023,880,784,10,2,13,0,55,16,788,762,6,0,13,0,3,4,92,22,4,2,0,0,52,12
250092522011,1248,1137,23,4,16,0,43,25,1113,1077,14,0,13,0,0,9,135,60,9,4,3,0,43,16
250092522012,1982,1693,49,2,68,0,138,32,1694,1575,35,2,67,0,5,10,288,118,14,0,1,0,133,22
250092522021,1944,1775,20,5,72,0,44,28,1875,1751,20,5,70,0,9,20,69,24,0,0,2,0,35,8
250092522022,1254,1221,4,0,12,0,11,6,1222,1200,4,0,12,0,0,6,32,21,0,0,0,0,11,0
250092523001,595,503,17,2,16,0,39,18,479,438,12,0,16,0,3,10,116,65,5,2,0,0,36,8
250092523002,1115,757,64,3,4,0,251,36,578,532,28,3,4,0,1,10,537,225,36,0,0,0,250,26
250092523003,1317,931,65,17,39,0,221,44,955,848,50,5,39,0,0,13,362,83,15,12,0,0,221,31
250092523004,1062,713,77,3,35,0,172,62,702,603,41,2,33,0,10,13,360,110,36,1,2,0,162,49
250092523005,1505,1255,63,1,49,1,93,43,1246,1135,38,0,49,0,2,22,259,120,25,1,0,1,91,21
250092523006,958,781,11,8,71,1,57,29,798,703,8,3,71,0,6,7,160,78,3,5,0,1,51,22
250092524001,1168,722,99,0,44,3,265,35,671,552,61,0,44,0,1,13,497,170,38,0,0,3,264,22
250092524002,1587,708,130,26,21,0,592,110,358,269,46,1,19,0,5,18,1229,439,84,25,2,0,587,92
250092524003,1420,749,99,11,62,1,394,104,541,440,28,2,58,1,1,11,879,309,71,9,4,0,393,93
250092525011,1804,1379,97,6,70,4,196,52,1361,1197,64,5,70,0,3,22,443,182,33,1,0,4,193,30
250092525012,1018,782,43,3,47,0,113,30,787,702,20,1,45,0,3,16,231,80,23,2,2,0,110,14
250092525013,1052,754,47,11,24,0,189,27,707,637,33,5,21,0,0,11,345,117,14,6,3,0,189,16
250092525021,1155,1077,26,0,15,0,25,12,1064,1011,26,0,15,0,0,12,91,66,0,0,0,0,25,0
250092525022,1756,1574,37,3,40,0,73,29,1553,1465,24,3,40,0,3,18,203,109,13,0,0,0,70,11
250092525023,954,859,10,3,42,0,24,16,856,796,6,1,42,0,0,11,98,63,4,2,0,0,24,5
250092525024,1000,803,37,1,60,0,80,19,822,713,31,1,60,0,7,10,178,90,6,0,0,0,73,9
250092526011,1805,1577,42,0,81,0,69,36,1651,1517,33,0,81,0,1,19,154,60,9,0,0,0,68,17
250092526012,1286,1121,5,0,87,0,57,16,1197,1092,5,0,87,0,2,11,89,29,0,0,0,0,55,5
250092526013,2173,1777,56,2,164,0,135,39,1919,1683,47,2,158,0,12,17,254,94,9,0,6,0,123,22
250092526014,1357,1216,27,4,30,0,67,13,1233,1162,22,1,30,0,9,9,124,54,5,3,0,0,58,4
250092526021,1132,923,43,6,59,0,74,27,939,836,23,5,59,0,5,11,193,87,20,1,0,0,69,16
250092526022,881,818,10,0,23,0,15,15,832,785,9,0,23,0,0,15,49,33,1,0,0,0,15,0
250092526023,453,387,2,1,46,0,13,4,416,365,2,1,46,0,0,2,37,22,0,0,0,0,13,2
250092526024,1941,1782,28,7,54,0,27,43,1835,1724,27,3,54,0,0,27,106,58,1,4,0,0,27,16
250092526031,3026,2602,55,12,194,0,113,50,2780,2499,46,8,194,0,1,32,246,103,9,4,0,0,112,18
250138123002,1552,1266,91,1,55,3,89,47,1304,1153,70,1,53,3,1,23,248,113,21,0,2,0,88,24
250138123003,2370,1785,130,13,175,2,175,90,1971,1605,121,2,175,2,1,65,399,180,9,11,0,0,174,25
250138123004,736,623,29,6,22,0,26,30,629,559,25,1,22,0,0,22,107,64,4,5,0,0,26,8
250138124011,736,717,0,2,4,0,1,12,715,699,0,2,4,0,0,10,21,18,0,0,0,0,1,2
250138124012,1594,1533,9,5,21,0,6,20,1553,1510,9,4,20,0,0,10,41,23,0,1,1,0,6,10
250138124013,1513,1453,2,1,24,0,17,16,1477,1435,2,1,23,0,4,12,36,18,0,0,1,0,13,4
250138124014,2367,2243,20,0,73,1,10,20,2320,2206,20,0,73,1,5,15,47,37,0,0,0,0,5,5
250138124031,862,783,24,3,7,0,29,16,793,749,23,3,7,0,0,11,69,34,1,0,0,0,29,5
250138124032,1008,876,33,2,49,0,16,32,940,833,32,0,49,0,0,26,68,43,1,2,0,0,16,6
250138124033,1141,1098,23,1,11,0,3,5,1103,1065,21,1,11,0,0,5,38,33,2,0,0,0,3,0
250138124034,785,712,0,0,56,0,10,7,769,706,0,0,56,0,0,7,16,6,0,0,0,0,10,0
250138124041,1799,1542,39,1,98,0,66,53,1626,1462,26,1,98,0,2,37,173,80,13,0,0,0,64,16
250138124042,2082,1954,19,1,63,2,7,36,2032,1917,19,1,63,2,0,30,50,37,0,0,0,0,7,6
250138125001,969,912,11,0,18,3,9,16,941,896,9,0,18,3,0,15,28,16,2,0,0,0,9,1
250138125002,1293,1227,8,4,13,0,17,24,1224,1191,5,2,13,0,0,13,69,36,3,2,0,0,17,11
250138125003,2332,2022,84,6,19,0,129,72,1837,1696,71,0,17,0,1,52,495,326,13,6,2,0,128,20
250138125004,624,597,7,3,4,0,4,9,601,587,4,2,4,0,0,4,23,10,3,1,0,0,4,5
250138125005,2447,2270,40,1,48,0,36,52,2349,2221,35,1,48,0,2,42,98,49,5,0,0,0,34,10
250138126001,1673,1579,19,4,28,1,7,35,1618,1540,19,4,28,0,0,27,55,39,0,0,0,1,7,8
250138126002,915,876,10,8,3,0,7,11,878,856,8,0,3,0,0,11,37,20,2,8,0,0,7,0
250138126003,2701,2524,40,7,68,0,35,27,2634,2496,40,7,67,0,0,24,67,28,0,0,1,0,35,3
250138126004,1510,1458,11,3,9,0,8,21,1454,1417,10,2,9,0,0,16,56,41,1,1,0,0,8,5
250138127011,1270,1173,22,1,21,0,24,29,1180,1118,17,1,20,0,2,22,90,55,5,0,1,0,22,7
250138127012,1590,1425,32,8,30,0,56,39,1377,1298,15,5,30,0,1,28,213,127,17,3,0,0,55,11
250138127013,1218,1086,15,4,13,1,68,31,1073,1023,7,4,13,0,1,25,145,63,8,0,0,1,67,6
250138127021,2122,1837,44,8,56,0,103,74,1799,1671,36,6,56,0,2,28,323,166,8,2,0,0,101,46
250138127022,2110,1870,69,10,12,0,87,62,1796,1698,48,7,12,0,2,29,314,172,21,3,0,0,85,33
250138127023,1257,1032,38,7,60,0,97,23,992,881,31,5,60,0,0,15,265,151,7,2,0,0,97,8
250138128001,819,676,23,1,1,0,92,26,612,581,20,0,1,0,0,10,207,95,3,1,0,0,92,16
250138128002,1728,1639,11,5,13,1,30,29,1636,1590,8,3,13,1,0,21,92,49,3,2,0,0,30,8
250138128003,2187,2126,18,0,19,2,6,16,2125,2077,15,0,19,2,0,12,62,49,3,0,0,0,6,4
250138128004,1932,1888,10,1,9,0,13,11,1871,1840,10,1,9,0,0,11,61,48,0,0,0,0,13,0
250138129011,1677,1623,3,5,14,0,6,26,1608,1571,2,0,14,0,0,21,69,52,1,5,0,0,6,5
250138129012,721,704,4,4,2,0,3,4,697,686,4,2,2,0,0,3,24,18,0,2,0,0,3,1
250138129013,604,573,7,9,5,0,7,3,542,527,7,2,5,0,0,1,62,46,0,7,0,0,7,2
250138129021,556,518,14,1,4,0,14,5,516,496,10,1,4,0,0,5,40,22,4,0,0,0,14,0
250138129022,1969,1918,12,0,12,0,11,16,1922,1884,12,0,12,0,0,14,47,34,0,0,0,0,11,2
250138129023,2277,2191,15,0,29,2,9,31,2222,2155,11,0,27,2,0,27,55,36,4,0,2,0,9,4
250138129031,2593,2378,96,3,24,0,30,62,2493,2334,89,1,22,0,0,47,100,44,7,2,2,0,30,15
250138130001,838,813,0,6,3,0,1,15,828,805,0,6,3,0,0,14,10,8,0,0,0,0,1,1
250138130002,1775,1734,13,3,5,0,2,18,1729,1701,12,2,5,0,1,8,46,33,1,1,0,0,1,10
250138130003,1337,1319,1,0,2,0,3,12,1322,1313,1,0,2,0,0,6,15,6,0,0,0,0,3,6
250138130004,1233,1213,4,2,4,0,2,8,1216,1199,4,1,4,0,0,8,17,14,0,1,0,0,2,0
250138130005,485,462,6,5,1,0,2,9,479,459,6,5,1,0,0,8,6,3,0,0,0,0,2,1
250138130006,1566,1522,9,5,5,0,6,19,1537,1508,4,5,5,0,0,15,29,14,5,0,0,0,6,4
250138131011,1979,1921,16,6,14,0,3,19,1953,1903,14,5,14,0,0,17,26,18,2,1,0,0,3,2
250138131012,1439,1400,7,5,3,2,7,15,1422,1391,7,5,3,2,0,14,17,9,0,0,0,0,7,1
250138131013,2470,2364,20,4,29,0,13,40,2409,2329,19,4,29,0,0,28,61,35,1,0,0,0,13,12
250138131021,1711,1636,17,4,22,0,5,27,1679,1609,17,4,22,0,1,26,32,27,0,0,0,0,4,1
250138131022,1903,1836,25,5,9,1,9,18,1841,1796,22,5,9,1,0,8,62,40,3,0,0,0,9,10
250138132041,817,804,3,1,0,0,2,7,810,799,3,1,0,0,0,7,7,5,0,0,0,0,2,0
250138132042,2423,2326,20,5,34,0,18,20,2371,2296,20,4,34,0,0,17,52,30,0,1,0,0,18,3
250138132051,2037,1973,23,5,16,0,1,19,2001,1942,21,5,16,0,0,17,36,31,2,0,0,0,1,2
250138132052,1165,1079,28,0,24,0,7,27,1104,1039,27,0,24,0,2,12,61,40,1,0,0,0,5,15
250138132053,2949,2835,16,5,40,0,24,29,2816,2734,16,3,40,0,0,23,133,101,0,2,0,0,24,6
250138132054,1330,1272,19,0,23,0,4,12,1294,1241,19,0,23,0,0,11,36,31,0,0,0,0,4,1
250138132061,1601,1542,15,2,6,0,6,30,1568,1517,15,2,6,0,0,28,33,25,0,0,0,0,6,2
250138132062,845,811,7,0,18,0,2,7,824,796,7,0,18,0,0,3,21,15,0,0,0,0,2,4
250138132063,1596,1506,22,1,34,0,13,20,1524,1455,18,1,33,0,0,17,72,51,4,0,1,0,13,3
250138132071,2258,2063,57,5,80,0,28,25,2162,1999,55,5,77,0,7,19,96,64,2,0,3,0,21,6
250138132072,1053,985,10,2,10,0,29,17,987,954,9,0,10,0,4,10,66,31,1,2,0,0,25,7
250138132073,1800,1683,37,5,42,0,15,18,1719,1630,30,1,42,0,1,15,81,53,7,4,0,0,14,3
250138132081,1503,1432,24,0,17,0,6,24,1479,1415,24,0,17,0,4,19,24,17,0,0,0,0,2,5
250138132082,1415,1280,31,4,50,0,19,31,1357,1260,18,1,49,0,4,25,58,20,13,3,1,0,15,6
250138132091,1213,1085,44,3,43,0,14,24,1158,1050,40,1,43,0,2,22,55,35,4,2,0,0,12,2
250138132092,1654,1566,29,2,34,0,7,16,1618,1547,27,1,33,0,1,9,36,19,2,1,1,0,6,7
250138132093,2779,2657,41,5,31,0,17,28,2706,2613,34,4,31,0,0,24,73,44,7,1,0,0,17,4
250138133011,2886,2761,20,0,58,1,7,39,2846,2729,20,0,58,1,1,37,40,32,0,0,0,0,6,2
250138133012,2401,2205,47,0,76,1,28,44,2310,2158,39,0,76,1,0,36,91,47,8,0,0,0,28,8
250138133013,2056,1887,19,4,98,0,19,29,1984,1838,19,3,96,0,2,26,72,49,0,1,2,0,17,3
250138133031,2160,1973,20,0,128,0,7,32,2121,1946,20,0,128,0,1,26,39,27,0,0,0,0,6,6
250138133032,2227,2061,18,0,131,0,3,14,2178,2019,15,0,131,0,0,13,49,42,3,0,0,0,3,1
250138133041,1849,1672,25,0,132,1,2,17,1809,1637,25,0,132,1,2,12,40,35,0,0,0,0,0,5
250138133042,1038,979,9,0,30,0,8,12,1022,967,9,0,30,0,5,11,16,12,0,0,0,0,3,1
250138133043,1167,1049,9,1,92,0,2,14,1144,1028,8,1,92,0,1,14,23,21,1,0,0,0,1,0
250138134011,1163,1084,11,0,52,0,11,5,1133,1067,11,0,52,0,0,3,30,17,0,0,0,0,11,2
250138134012,1057,974,34,0,16,0,10,23,1023,957,30,0,16,0,3,17,34,17,4,0,0,0,7,6
250138134013,2037,1881,37,2,66,0,16,35,1977,1839,35,2,66,0,3,32,60,42,2,0,0,0,13,3
250138134014,986,927,13,3,16,0,9,18,950,910,12,3,16,0,0,9,36,17,1,0,0,0,9,9
250138134031,2600,2502,27,3,37,0,6,25,2556,2470,26,3,37,0,0,20,44,32,1,0,0,0,6,5
250138134032,1247,1203,4,3,28,0,1,8,1209,1172,4,1,28,0,0,4,38,31,0,2,0,0,1,4
250138134041,2152,2048,30,0,41,0,8,25,2134,2034,30,0,41,0,7,22,18,14,0,0,0,0,1,3
250138134042,1876,1811,14,0,30,0,9,12,1828,1775,14,0,29,0,1,9,48,36,0,0,1,0,8,3
250138134043,2602,2428,52,0,91,0,5,26,2553,2388,50,0,91,0,2,22,49,40,2,0,0,0,3,4
250138135001,1406,1350,10,0,22,0,10,14,1385,1337,10,0,22,0,2,14,21,13,0,0,0,0,8,0
250138135002,1061,1019,2,1,20,0,5,14,1053,1014,2,1,20,0,2,14,8,5,0,0,0,0,3,0
250138135003,1476,1421,13,0,22,1,0,19,1454,1399,13,0,22,1,0,19,22,22,0,0,0,0,0,0
250138135004,1196,1178,0,2,6,0,6,4,1172,1158,0,2,6,0,3,3,24,20,0,0,0,0,3,1
250138136011,821,801,3,0,1,0,6,10,800,786,3,0,1,0,0,10,21,15,0,0,0,0,6,0
250138136012,2448,2303,53,0,53,0,8,31,2388,2263,49,0,53,0,2,21,60,40,4,0,0,0,6,10
250138136013,1494,1387,43,0,44,1,3,16,1465,1369,38,0,44,1,0,13,29,18,5,0,0,0,3,3
250138136014,1145,1080,19,1,15,0,10,20,1108,1053,18,1,15,0,2,19,37,27,1,0,0,0,8,1
250138136015,1278,1086,82,3,47,0,25,35,1196,1040,78,0,47,0,6,25,82,46,4,3,0,0,19,10
250138136016,960,908,15,0,17,0,7,13,932,891,15,0,17,0,0,9,28,17,0,0,0,0,7,4
250138136021,1128,1094,14,3,12,0,1,4,1103,1073,14,0,12,0,1,3,25,21,0,3,0,0,0,1
250138136022,3006,2849,51,3,71,0,13,19,2932,2803,40,3,70,0,3,13,74,46,11,0,1,0,10,6
250138136023,1939,1859,27,0,26,0,4,23,1902,1830,22,0,26,0,2,22,37,29,5,0,0,0,2,1
250138137011,1672,1623,18,0,9,0,7,15,1640,1604,18,0,9,0,0,9,32,19,0,0,0,0,7,6
250138137012,1790,1735,10,2,14,0,2,27,1756,1709,10,2,14,0,1,20,34,26,0,0,0,0,1,7
250138137021,1570,1514,23,3,5,0,2,23,1537,1486,19,3,5,0,2,22,33,28,4,0,0,0,0,1
250138137022,2214,2156,11,4,14,0,6,23,2173,2125,7,4,14,0,4,19,41,31,4,0,0,0,2,4
250138137023,758,723,9,6,6,0,0,14,747,712,9,6,6,0,0,14,11,11,0,0,0,0,0,0
250138137024,233,229,1,0,0,0,0,3,231,229,1,0,0,0,0,1,2,0,0,0,0,0,0,2
250138137025,323,307,1,3,4,0,0,8,323,307,1,3,4,0,0,8,0,0,0,0,0,0,0,0
250138138011,1838,1778,17,4,3,0,8,28,1809,1761,17,4,3,0,0,24,29,17,0,0,0,0,8,4
250138138012,1165,1148,2,4,2,0,1,8,1140,1124,2,4,2,0,0,8,25,24,0,0,0,0,1,0
250138138013,1316,1256,13,7,9,0,9,22,1284,1234,12,7,9,0,2,20,32,22,1,0,0,0,7,2
250138138021,2027,1977,14,5,6,2,3,20,1986,1941,14,5,6,0,1,19,41,36,0,0,0,2,2,1
250138138022,1582,1515,14,5,11,0,1,36,1544,1482,13,5,11,0,0,33,38,33,1,0,0,0,1,3
250158201011,2498,2383,18,3,27,0,15,52,2461,2369,17,3,27,0,3,42,37,14,1,0,0,0,12,10
250158201012,1771,1697,13,2,6,0,17,36,1716,1663,13,1,3,0,4,32,55,34,0,1,3,0,13,4
250158201013,1063,1019,3,5,12,0,10,14,1044,1011,2,5,12,0,0,14,19,8,1,0,0,0,10,0
250158201014,857,832,11,1,1,0,3,9,832,818,10,1,1,0,0,2,25,14,1,0,0,0,3,7
250158201021,789,749,7,2,5,0,5,21,746,718,6,2,5,0,0,15,43,31,1,0,0,0,5,6
250158201022,1004,913,14,5,14,0,27,31,939,885,14,5,14,0,0,21,65,28,0,0,0,0,27,10
250158201023,1890,1699,36,12,6,0,60,77,1745,1637,33,8,6,0,0,61,145,62,3,4,0,0,60,16
250158202021,1321,1235,23,2,23,0,11,27,1280,1209,22,2,23,0,2,22,41,26,1,0,0,0,9,5
250158202031,2767,2510,50,3,78,4,47,75,2637,2450,45,2,78,4,2,56,130,60,5,1,0,0,45,19
250158202032,1889,1826,15,3,13,2,7,23,1856,1807,13,3,13,0,0,20,33,19,2,0,0,2,7,3
250158202033,1387,1270,26,2,58,0,8,23,1333,1228,25,2,57,0,0,21,54,42,1,0,1,0,8,2
250158202034,2464,2319,25,7,49,1,26,37,2401,2271,24,6,49,1,17,33,63,48,1,1,0,0,9,4
250158202041,2807,2691,29,2,34,1,11,39,2755,2657,29,2,34,1,3,29,52,34,0,0,0,0,8,10
250158202042,3335,3125,54,4,73,0,16,63,3282,3091,54,3,73,0,7,54,53,34,0,1,0,0,9,9
250158203001,1709,1481,54,1,85,0,19,69,1637,1435,50,0,85,0,7,60,72,46,4,1,0,0,12,9
250158203002,1401,1032,81,15,132,5,45,91,1230,960,67,7,132,5,4,55,171,72,14,8,0,0,41,36
250158203003,973,819,25,1,94,2,8,24,928,787,23,1,94,0,1,22,45,32,2,0,0,2,7,2
250158203004,1388,793,79,1,427,0,31,57,1295,746,72,1,426,0,4,46,93,47,7,0,1,0,27,11
250158203005,1347,1055,35,1,198,2,13,43,1281,1008,30,1,198,2,4,38,66,47,5,0,0,0,9,5
250158204001,5791,4579,476,8,393,1,130,204,5458,4440,412,6,390,1,36,173,333,139,64,2,3,0,94,31
250158204002,6288,4780,229,9,965,0,80,225,6017,4638,206,6,960,0,21,186,271,142,23,3,5,0,59,39
250158205001,1173,968,46,1,92,0,16,50,1094,928,37,1,92,0,2,34,79,40,9,0,0,0,14,16
250158205002,941,840,32,4,27,0,10,28,898,818,29,2,27,0,3,19,43,22,3,2,0,0,7,9
250158205003,766,671,40,0,18,0,16,21,702,640,28,0,18,0,1,15,64,31,12,0,0,0,15,6
250158205004,1075,943,21,3,64,0,16,28,1019,905,19,2,64,0,5,24,56,38,2,1,0,0,11,4
250158205005,1116,892,39,2,113,0,34,36,1027,840,34,1,113,0,6,33,89,52,5,1,0,0,28,3
250158205006,1271,1120,22,1,84,1,19,24,1212,1084,22,1,82,1,3,19,59,36,0,0,2,0,16,5
250158206001,1681,1096,203,2,219,0,49,112,1464,964,189,1,217,0,9,84,217,132,14,1,2,0,40,28
250158207001,1719,1183,121,9,187,0,101,118,1472,1095,103,1,179,0,13,81,247,88,18,8,8,0,88,37
250158207002,1450,964,86,2,265,0,44,89,1317,904,82,1,264,0,2,64,133,60,4,1,1,0,42,25
250158207003,1340,1133,33,0,142,0,7,25,1279,1081,31,0,142,0,2,23,61,52,2,0,0,0,5,2
250158208011,996,852,45,4,34,0,20,41,940,829,42,1,34,0,3,31,56,23,3,3,0,0,17,10
250158208012,1526,1389,32,5,52,0,23,25,1472,1359,30,4,52,0,8,19,54,30,2,1,0,0,15,6
250158208013,1932,956,227,18,402,2,187,140,1528,805,196,8,395,2,10,112,404,151,31,10,7,0,177,28
250158208014,778,571,68,2,85,0,6,46,714,531,67,0,84,0,0,32,64,40,1,2,1,0,6,14
250158208021,1158,959,50,3,62,0,24,60,1078,920,46,2,61,0,2,47,80,39,4,1,1,0,22,13
250173011012,1210,1143,12,0,19,0,9,27,1176,1123,12,0,18,0,0,23,34,20,0,0,1,0,9,4
250173011013,928,900,8,2,4,0,0,14,908,882,8,2,4,0,0,12,20,18,0,0,0,0,0,2
250173011021,1281,1239,6,6,17,0,1,12,1261,1221,6,6,17,0,1,10,20,18,0,0,0,0,0,2
250173011022,2091,2043,7,1,6,0,11,23,2055,2016,7,1,6,0,3,22,36,27,0,0,0,0,8,1
250173011023,1530,1497,7,3,3,0,3,17,1514,1488,6,3,3,0,0,14,16,9,1,0,0,0,3,3
250173101001,1448,995,145,4,90,0,135,79,1139,843,129,4,86,0,28,49,309,152,16,0,4,0,107,30
250173101002,1972,1549,136,8,66,1,143,69,1565,1353,99,5,66,1,2,39,407,196,37,3,0,0,141,30
250173101003,1847,982,285,9,143,0,330,98,1161,658,264,0,138,0,56,45,686,324,21,9,5,0,274,53
250173102001,1115,936,50,0,54,0,53,22,1012,897,47,0,54,0,3,11,103,39,3,0,0,0,50,11
250173102002,911,718,53,0,67,0,44,29,825,685,47,0,67,0,6,20,86,33,6,0,0,0,38,9
250173102003,1562,863,222,6,130,0,243,98,1059,634,207,2,129,0,21,66,503,229,15,4,1,0,222,32
250173102004,1111,801,93,0,86,4,82,45,897,689,86,0,86,4,12,20,214,112,7,0,0,0,70,25
250173102005,1277,920,106,0,118,0,91,42,1070,815,98,0,115,0,16,26,207,105,8,0,3,0,75,16
250173103001,1465,1004,177,3,101,0,113,67,1214,902,162,0,96,0,21,33,251,102,15,3,5,0,92,34
250173103002,1618,924,203,6,163,0,248,74,1062,673,178,0,162,0,18,31,556,251,25,6,1,0,230,43
250173103003,1196,781,94,2,124,0,125,70,880,619,83,1,124,0,9,44,316,162,11,1,0,0,116,26
250173103004,852,587,79,3,71,0,74,38,678,502,70,0,71,0,10,25,174,85,9,3,0,0,64,13
250173103005,885,687,61,7,45,0,59,26,767,626,60,7,45,0,10,19,118,61,1,0,0,0,49,7
250173104001,1184,609,123,6,156,0,221,69,676,384,105,0,151,0,4,32,508,225,18,6,5,0,217,37
250173104002,1125,764,91,2,128,0,93,47,831,597,77,2,119,0,17,19,294,167,14,0,9,0,76,28
250173104003,936,504,72,0,145,4,153,58,615,390,41,0,144,0,11,29,321,114,31,0,1,4,142,29
250173105001,937,681,94,4,94,0,34,30,839,638,84,4,94,0,1,18,98,43,10,0,0,0,33,12
250173105002,1377,890,86,6,254,2,91,48,1175,793,74,6,252,2,19,29,202,97,12,0,2,0,72,19
250173105003,1135,852,53,0,137,1,76,16,1002,800,47,0,137,0,9,9,133,52,6,0,0,1,67,7
250173106011,2211,1491,93,3,428,0,97,99,1858,1298,81,2,428,0,1,48,353,193,12,1,0,0,96,51
250173106012,2751,2137,138,7,353,0,61,55,2597,2057,135,7,352,0,8,38,154,80,3,0,1,0,53,17
250173106013,784,598,39,0,88,3,37,19,680,521,39,0,88,1,18,13,104,77,0,0,0,2,19,6
250173106021,1693,1070,106,4,330,0,115,68,1534,1004,97,3,330,0,43,57,159,66,9,1,0,0,72,11
250173106022,1799,1495,77,1,109,0,69,48,1614,1411,63,0,102,0,5,33,185,84,14,1,7,0,64,15
250173106023,604,455,46,2,62,0,24,15,518,399,45,1,62,0,0,11,86,56,1,1,0,0,24,4
250173106024,1729,1336,132,0,193,0,43,25,1592,1262,116,0,193,0,3,18,137,74,16,0,0,0,40,7
250173107001,1536,775,82,2,392,0,219,66,1214,687,72,1,389,0,27,38,322,88,10,1,3,0,192,28
250173107002,1142,691,57,4,244,0,93,53,1004,649,48,3,244,0,22,38,138,42,9,1,0,0,71,15
250173107003,1763,801,119,10,535,0,249,49,1447,723,111,0,533,0,47,33,316,78,8,10,2,0,202,16
250173111001,1002,324,64,21,364,0,174,55,681,222,53,6,364,0,14,22,321,102,11,15,0,0,160,33
250173111002,1408,541,126,15,461,2,211,52,937,360,84,5,458,0,8,22,471,181,42,10,3,2,203,30
250173112001,1561,350,104,4,875,0,175,53,1281,292,84,0,860,0,15,30,280,58,20,4,15,0,160,23
250173112002,1706,485,103,1,947,0,99,71,1505,419,92,1,941,0,9,43,201,66,11,0,6,0,90,28
250173113001,1221,439,83,2,544,0,111,42,1052,386,73,0,542,0,28,23,169,53,10,2,2,0,83,19
250173113002,1649,714,139,2,599,0,141,54,1411,627,132,1,598,0,20,33,238,87,7,1,1,0,121,21
250173113003,1187,642,44,0,408,0,69,24,1074,586,40,0,407,0,26,15,113,56,4,0,1,0,43,9
250173114001,1158,743,59,3,275,0,38,40,1075,709,54,2,274,0,16,20,83,34,5,1,1,0,22,20
250173114002,639,476,24,0,100,0,25,14,599,456,24,0,100,0,6,13,40,20,0,0,0,0,19,1
250173114003,2301,986,314,18,667,0,224,92,1841,786,297,5,665,0,34,54,460,200,17,13,2,0,190,38
250173114004,1888,818,290,2,502,3,187,86,1616,708,278,1,500,3,57,69,272,110,12,1,2,0,130,17
250173115001,837,403,29,0,316,1,48,40,755,376,26,0,314,1,13,25,82,27,3,0,2,0,35,15
250173115002,1243,584,82,2,483,2,54,36,1145,554,74,0,478,2,12,25,98,30,8,2,5,0,42,11
250173115003,894,580,56,1,180,0,53,24,830,558,55,1,180,0,19,17,64,22,1,0,0,0,34,7
250173116001,1410,1050,17,1,277,0,38,27,1351,1025,16,0,277,0,13,20,59,25,1,1,0,0,25,7
250173116002,1305,721,37,1,480,0,38,28,1239,686,35,1,478,0,13,26,66,35,2,0,2,0,25,2
250173116003,754,654,9,0,77,0,8,6,732,641,9,0,77,0,0,5,22,13,0,0,0,0,8,1
250173116004,967,355,103,6,252,0,216,35,703,291,95,1,251,0,41,24,264,64,8,5,1,0,175,11
250173116005,859,492,39,0,289,0,22,17,812,467,34,0,288,0,7,16,47,25,5,0,1,0,15,1
250173117001,864,481,41,0,293,0,26,23,764,426,34,0,284,0,5,15,100,55,7,0,9,0,21,8
250173117002,1095,484,50,0,454,0,56,51,950,407,48,0,449,0,6,40,145,77,2,0,5,0,50,11
250173117003,1260,418,80,1,556,0,127,78,1025,335,68,1,555,0,19,47,235,83,12,0,1,0,108,31
250173117004,1879,498,78,3,1086,7,134,73,1678,438,59,1,1086,7,24,63,201,60,19,2,0,0,110,10
250173118001,1728,503,95,10,913,0,149,58,1433,382,91,1,910,0,7,42,295,121,4,9,3,0,142,16
250173118002,1785,517,62,9,941,0,162,94,1499,415,57,1,938,0,20,68,286,102,5,8,3,0,142,26
250173119001,1445,851,98,3,173,2,248,70,1083,705,78,2,170,2,81,45,362,146,20,1,3,0,167,25
250173119002,984,615,80,9,142,0,107,31,756,519,66,7,139,0,4,21,228,96,14,2,3,0,103,10
250173120001,1479,882,128,11,233,1,139,85,1185,739,96,7,231,1,55,56,294,143,32,4,2,0,84,29
250173120002,1459,857,99,10,225,0,194,74,1037,649,79,9,219,0,37,44,422,208,20,1,6,0,157,30
250173121001,1107,634,76,1,167,0,184,45,845,540,64,1,162,0,46,32,262,94,12,0,5,0,138,13
250173121002,1085,539,62,4,284,0,158,38,840,415,48,3,284,0,66,24,245,124,14,1,0,0,92,14
250173121003,957,504,103,0,207,0,86,57,806,445,96,0,205,0,25,35,151,59,7,0,2,0,61,22
250173122001,1697,1025,136,0,332,0,144,60,1468,913,125,0,332,0,48,50,229,112,11,0,0,0,96,10
250173122002,795,430,43,2,216,1,91,12,651,382,37,2,214,1,5,10,144,48,6,0,2,0,86,2
250173122003,965,565,79,0,218,0,62,41,811,490,72,0,214,0,10,25,154,75,7,0,4,0,52,16
250173122004,852,613,41,0,158,0,22,18,781,579,40,0,151,0,1,10,71,34,1,0,7,0,21,8
250173123001,1369,1000,94,5,150,0,85,35,1260,933,91,5,148,0,51,32,109,67,3,0,2,0,34,3
250173123002,1238,960,43,1,125,0,60,49,1135,913,38,0,125,0,23,36,103,47,5,1,0,0,37,13
250173123003,2324,1874,113,2,162,1,122,50,2040,1727,103,0,160,0,16,34,284,147,10,2,2,1,106,16
250173124001,632,403,84,4,29,0,80,32,428,313,65,3,29,0,8,10,204,90,19,1,0,0,72,22
250173124002,1722,993,116,7,154,0,376,76,956,646,83,2,146,0,44,35,766,347,33,5,8,0,332,41
250173125011,1904,1681,44,1,86,0,50,42,1813,1634,43,1,86,0,15,34,91,47,1,0,0,0,35,8
250173125012,610,555,6,0,36,0,10,3,588,546,6,0,30,0,3,3,22,9,0,0,6,0,7,0
250173125013,1950,1430,140,9,176,3,136,56,1661,1277,131,7,176,3,31,36,289,153,9,2,0,0,105,20
250173125021,1994,1688,69,4,90,2,117,24,1763,1542,60,3,89,2,44,23,231,146,9,1,1,0,73,1
250173125022,730,696,11,0,11,0,7,5,719,688,11,0,11,0,4,5,11,8,0,0,0,0,3,0
250173125023,1236,1112,20,2,70,0,13,19,1204,1093,18,2,70,0,3,18,32,19,2,0,0,0,10,1
250173131011,1654,1479,18,3,107,0,20,27,1587,1444,17,1,106,0,0,19,67,35,1,2,1,0,20,8
250173131012,2825,2554,17,6,190,0,10,48,2785,2531,16,5,189,0,2,42,40,23,1,1,1,0,8,6
250173131013,1009,971,0,0,21,0,7,10,989,958,0,0,21,0,1,9,20,13,0,0,0,0,6,1
250173131021,842,798,9,0,16,0,10,9,817,788,9,0,16,0,0,4,25,10,0,0,0,0,10,5
250173131022,874,761,23,1,50,0,20,19,842,751,23,1,49,0,3,15,32,10,0,0,1,0,17,4
250173131023,2548,2366,37,3,94,0,4,44,2498,2333,37,1,94,0,0,33,50,33,0,2,0,0,4,11
250173131024,1540,1461,16,1,57,0,3,2,1509,1432,16,1,56,0,3,1,31,29,0,0,1,0,0,1
250173141011,1500,1378,20,3,61,0,13,25,1472,1367,18,3,61,0,2,21,28,11,2,0,0,0,11,4
250173141012,1859,1764,23,0,49,0,12,11,1800,1725,16,0,49,0,3,7,59,39,7,0,0,0,9,4
250173141013,2696,2249,200,9,138,0,50,50,2568,2177,198,8,135,0,11,39,128,72,2,1,3,0,39,11
250173141021,1654,1527,31,3,63,0,12,18,1596,1484,28,0,63,0,4,17,58,43,3,3,0,0,8,1
250173141022,1417,1287,36,0,62,0,8,24,1363,1252,33,0,62,0,1,15,54,35,3,0,0,0,7,9
250173141023,1376,1150,69,1,82,0,25,49,1316,1116,61,1,82,0,15,41,60,34,8,0,0,0,10,8
250173141024,1603,1343,40,4,122,0,43,51,1528,1315,38,2,119,0,17,37,75,28,2,2,3,0,26,14
250173141025,1173,1077,22,0,38,0,15,21,1124,1046,21,0,37,0,3,17,49,31,1,0,1,0,12,4
250173142001,1650,1478,44,5,59,0,24,40,1539,1407,43,5,58,0,4,22,111,71,1,0,1,0,20,18
250173142002,1452,1331,24,0,39,0,34,24,1376,1289,24,0,39,0,10,14,76,42,0,0,0,0,24,10
250173142003,2131,2016,18,2,61,3,13,18,2078,1983,17,2,61,0,0,15,53,33,1,0,0,3,13,3
250173143011,1596,1445,19,1,112,1,5,13,1570,1429,18,1,112,1,0,9,26,16,1,0,0,0,5,4
250173143012,590,545,11,3,3,0,19,9,545,522,11,1,3,0,3,5,45,23,0,2,0,0,16,4
250173143013,2302,2191,30,1,41,1,9,29,2238,2153,24,1,41,0,0,19,64,38,6,0,0,1,9,10
250173143014,1514,1309,35,0,111,2,20,37,1457,1281,35,0,111,2,7,21,57,28,0,0,0,0,13,16
250173143015,2009,1721,84,1,79,0,88,36,1863,1664,76,1,79,0,15,28,146,57,8,0,0,0,73,8
250173143021,1164,1095,14,4,37,0,6,8,1130,1072,13,4,35,0,0,6,34,23,1,0,2,0,6,2
250173143022,1771,1704,17,3,29,0,4,14,1745,1683,17,3,29,0,1,12,26,21,0,0,0,0,3,2
250173151001,2686,2532,18,0,89,0,15,32,2629,2494,18,0,89,0,3,25,57,38,0,0,0,0,12,7
250173151002,2770,2577,36,1,89,0,17,50,2716,2542,35,1,89,0,1,48,54,35,1,0,0,0,16,2
250173152001,1668,1411,43,0,171,0,18,25,1628,1396,35,0,171,0,5,21,40,15,8,0,0,0,13,4
250173152002,2248,2140,22,2,63,1,6,14,2205,2105,22,2,63,1,0,12,43,35,0,0,0,0,6,2
250173152003,1534,1470,7,2,20,0,16,19,1482,1434,7,2,20,0,4,15,52,36,0,0,0,0,12,4
250173152004,2135,2039,27,1,44,0,3,21,2113,2019,27,1,44,0,1,21,22,20,0,0,0,0,2,0
250173154011,2007,1925,13,0,42,0,2,25,1982,1902,13,0,41,0,1,25,25,23,0,0,1,0,1,0
250173154012,1525,1350,74,6,71,0,9,15,1434,1269,70,4,71,0,6,14,91,81,4,2,0,0,3,1
250173154021,930,876,9,1,28,0,2,14,918,866,9,1,28,0,0,14,12,10,0,0,0,0,2,0
250173154022,1991,1908,19,7,34,0,7,16,1953,1883,18,7,34,0,0,11,38,25,1,0,0,0,7,5
250173154031,744,720,9,0,7,0,0,8,740,716,9,0,7,0,0,8,4,4,0,0,0,0,0,0
250173154032,1001,964,13,1,9,0,2,12,986,956,13,1,9,0,0,7,15,8,0,0,0,0,2,5
250173155001,1393,1334,4,0,22,0,3,30,1359,1302,4,0,22,0,3,28,34,32,0,0,0,0,0,2
250173155002,1307,1242,4,0,26,0,18,17,1278,1223,4,0,26,0,10,15,29,19,0,0,0,0,8,2
250173155003,758,707,10,1,16,0,17,7,730,694,10,1,16,0,3,6,28,13,0,0,0,0,14,1
250173155004,1087,1058,1,0,11,0,3,14,1076,1049,1,0,11,0,2,13,11,9,0,0,0,0,1,1
250173155005,1516,1479,1,7,9,0,9,11,1484,1451,1,5,9,0,9,9,32,28,0,2,0,0,0,2
250173155006,1661,1595,11,3,35,0,4,13,1646,1585,11,2,35,0,1,12,15,10,0,1,0,0,3,1
250173161011,1738,1681,8,1,34,0,0,14,1706,1655,8,1,34,0,0,8,32,26,0,0,0,0,0,6
250173161012,1377,1304,20,1,33,0,12,7,1352,1292,20,1,33,0,0,6,25,12,0,0,0,0,12,1
250173161013,1993,1916,8,5,27,0,7,30,1958,1889,8,5,27,0,2,27,35,27,0,0,0,0,5,3
250173161021,1566,1523,7,0,20,0,9,7,1528,1495,6,0,20,0,1,6,38,28,1,0,0,0,8,1
250173161022,2455,2301,51,1,63,0,10,29,2424,2280,46,1,63,0,6,28,31,21,5,0,0,0,4,1
250173161023,897,840,1,1,47,0,4,4,878,825,1,1,47,0,0,4,19,15,0,0,0,0,4,0
250173161024,1142,1066,10,3,35,0,6,22,1127,1058,10,3,35,0,0,21,15,8,0,0,0,0,6,1
250173162011,1152,1067,7,1,56,0,7,14,1130,1053,7,1,56,0,0,13,22,14,0,0,0,0,7,1
250173162012,2027,1866,8,2,121,0,16,14,1990,1842,8,2,121,0,4,13,37,24,0,0,0,0,12,1
250173162013,925,881,14,5,15,0,2,8,911,874,14,1,15,0,0,7,14,7,0,4,0,0,2,1
250173162021,1526,1279,29,7,151,0,10,50,1481,1257,29,4,151,0,5,35,45,22,0,3,0,0,5,15
250173162022,1729,1514,24,0,158,2,8,23,1714,1499,24,0,158,2,8,23,15,15,0,0,0,0,0,0
250173162023,1035,916,22,1,75,0,15,6,995,891,22,1,75,0,0,6,40,25,0,0,0,0,15,0
250173163001,2746,2028,96,2,502,1,51,66,2641,1968,94,2,502,1,17,57,105,60,2,0,0,0,34,9
250173163002,780,737,5,0,18,0,9,11,763,725,5,0,18,0,6,9,17,12,0,0,0,0,3,2
250173163003,889,785,31,1,37,0,1,34,871,768,31,1,36,0,1,34,18,17,0,0,1,0,0,0
250173163004,1125,1029,22,2,42,0,0,30,1115,1023,22,2,42,0,0,26,10,6,0,0,0,0,0,4
250173163005,1909,1656,75,3,132,1,14,28,1832,1595,74,3,132,1,4,23,77,61,1,0,0,0,10,5
250173163006,723,662,10,0,31,0,11,9,709,655,10,0,31,0,5,8,14,7,0,0,0,0,6,1
250173164001,929,857,15,0,47,0,2,8,921,851,15,0,47,0,0,8,8,6,0,0,0,0,2,0
250173164002,1008,941,17,1,35,0,10,4,986,929,15,0,35,0,4,3,22,12,2,1,0,0,6,1
250173164003,896,806,21,4,41,0,8,16,873,798,17,4,41,0,0,13,23,8,4,0,0,0,8,3
250173164004,1775,1637,22,0,96,1,1,18,1753,1622,18,0,96,1,1,15,22,15,4,0,0,0,0,3
250173164005,1164,1028,10,0,85,0,12,29,1129,1011,9,0,82,0,1,26,35,17,1,0,3,0,11,3
250173164006,798,561,216,9,5,0,7,0,681,452,215,9,5,0,0,0,117,109,1,0,0,0,7,0
250173165001,1557,1417,30,0,58,0,28,24,1488,1375,30,0,58,0,3,22,69,42,0,0,0,0,25,2
250173165002,1107,974,18,1,81,3,4,26,1068,942,16,1,81,3,0,25,39,32,2,0,0,0,4,1
250173165003,1057,981,3,1,53,0,1,18,1027,954,3,1,51,0,0,18,30,27,0,0,2,0,1,0
250173165004,1433,1336,28,4,48,0,8,9,1390,1305,28,2,46,0,2,7,43,31,0,2,2,0,6,2
250173165005,785,696,21,3,48,0,8,9,767,685,21,2,48,0,4,7,18,11,0,1,0,0,4,2
250173171011,1222,1070,8,1,124,0,2,17,1208,1059,8,0,123,0,1,17,14,11,0,1,1,0,1,0
250173171012,1396,1196,25,1,144,0,11,19,1363,1175,23,1,144,0,3,17,33,21,2,0,0,0,8,2
250173171013,1242,1129,21,1,78,1,0,12,1212,1105,20,1,78,1,0,7,30,24,1,0,0,0,0,5
250173171014,2279,1931,29,6,265,0,6,42,2230,1899,24,5,265,0,2,35,49,32,5,1,0,0,4,7
250173171021,1625,1410,40,1,141,0,7,26,1586,1380,40,1,141,0,1,23,39,30,0,0,0,0,6,3
250173171022,1003,755,4,1,231,0,5,7,976,734,4,1,231,0,0,6,27,21,0,0,0,0,5,1
250173171023,1725,1571,30,0,99,0,9,16,1691,1552,26,0,99,0,0,14,34,19,4,0,0,0,9,2
250173171031,1955,1784,13,1,124,0,10,23,1917,1759,13,1,124,0,5,15,38,25,0,0,0,0,5,8
250173171032,1985,1874,6,1,88,0,5,11,1959,1853,6,1,88,0,0,11,26,21,0,0,0,0,5,0
250173171033,955,865,2,0,71,0,0,17,943,855,2,0,71,0,0,15,12,10,0,0,0,0,0,2
250173172011,1426,1346,8,3,53,0,5,11,1404,1331,7,3,53,0,3,7,22,15,1,0,0,0,2,4
250173172012,1423,1343,6,3,56,1,3,11,1393,1315,5,3,56,1,2,11,30,28,1,0,0,0,1,0
250173172021,1413,1277,9,1,90,0,8,28,1388,1260,9,0,90,0,4,25,25,17,0,1,0,0,4,3
250173172022,1975,1845,5,0,92,0,1,32,1937,1810,5,0,92,0,0,30,38,35,0,0,0,0,1,2
250173172031,797,759,2,4,25,0,2,5,782,746,2,4,25,0,0,5,15,13,0,0,0,0,2,0
250173172032,2430,2208,18,3,159,0,8,34,2394,2181,15,3,159,0,4,32,36,27,3,0,0,0,4,2
250173172033,776,590,20,0,148,0,3,15,771,586,20,0,148,0,2,15,5,4,0,0,0,0,1,0
250173173011,1982,1620,13,2,313,0,10,24,1919,1573,11,2,312,0,2,19,63,47,2,0,1,0,8,5
250173173012,645,528,19,0,79,0,10,9,623,518,19,0,79,0,2,5,22,10,0,0,0,0,8,4
250173173021,1511,1340,17,2,106,0,8,38,1483,1323,17,0,105,0,2,36,28,17,0,2,1,0,6,2
250173173022,2550,2308,38,4,150,0,15,35,2483,2265,37,4,144,0,1,32,67,43,1,0,6,0,14,3
250173173023,1487,1195,25,0,210,0,17,40,1454,1176,25,0,210,0,6,37,33,19,0,0,0,0,11,3
250173181001,2333,2057,6,0,242,0,5,23,2307,2032,6,0,242,0,5,22,26,25,0,0,0,0,0,1
250173181002,1387,1274,7,6,75,0,11,14,1353,1253,1,6,75,0,5,13,34,21,6,0,0,0,6,1
250173181003,724,642,1,0,62,0,6,13,715,639,1,0,62,0,1,12,9,3,0,0,0,0,5,1
250173181004,2230,1428,5,2,745,1,7,42,2210,1416,5,0,745,1,2,41,20,12,0,2,0,0,5,1
250173182001,2626,2249,16,0,315,0,5,41,2583,2214,16,0,315,0,0,38,43,35,0,0,0,0,5,3
250173182002,1227,1123,10,1,67,0,7,19,1202,1103,10,0,67,0,6,16,25,20,0,1,0,0,1,3
250173183001,817,746,2,0,45,0,7,17,801,734,1,0,45,0,5,16,16,12,1,0,0,0,2,1
250173183002,2464,2149,9,5,267,0,5,29,2425,2114,9,4,267,0,2,29,39,35,0,1,0,0,3,0
250173183003,1530,1202,4,0,290,0,5,29,1510,1190,3,0,290,0,0,27,20,12,1,0,0,0,5,2
250173183004,2705,2415,7,1,224,0,7,51,2659,2373,6,1,224,0,4,51,46,42,1,0,0,0,3,0
250173184001,2551,2237,15,0,267,0,3,29,2526,2217,15,0,266,0,1,27,25,20,0,0,1,0,2,2
250173184002,1357,1156,1,3,163,0,2,32,1327,1140,1,1,163,0,0,22,30,16,0,2,0,0,2,10
250173201021,992,880,17,0,77,0,7,11,970,858,17,0,77,0,7,11,22,22,0,0,0,0,0,0
250173201022,1119,1024,5,1,57,0,9,23,1091,1004,5,1,57,0,3,21,28,20,0,0,0,0,6,2
250173201023,2929,2763,22,2,90,0,7,45,2891,2730,21,1,90,0,4,45,38,33,1,1,0,0,3,0
250173201031,2795,2501,31,3,213,0,11,36,2740,2463,31,3,213,0,0,30,55,38,0,0,0,0,11,6
250173201041,2813,2658,19,4,98,0,10,24,2760,2617,19,2,97,0,4,21,53,41,0,2,1,0,6,3
250173201042,2967,2826,17,0,91,0,11,22,2919,2783,17,0,91,0,10,18,48,43,0,0,0,0,1,4
250173201043,1310,1250,12,1,29,0,0,18,1287,1232,12,1,29,0,0,13,23,18,0,0,0,0,0,5
250173211001,3835,3218,101,6,176,0,226,108,3539,3052,89,4,175,0,137,82,296,166,12,2,1,0,89,26
250173211002,2397,1908,95,3,241,0,64,86,2260,1809,94,2,241,0,40,74,137,99,1,1,0,0,24,12
250173211003,760,688,13,0,20,0,17,22,736,682,13,0,20,0,1,20,24,6,0,0,0,0,16,2
250173212001,2819,2271,72,11,125,0,204,136,2689,2182,70,10,125,0,173,129,130,89,2,1,0,0,31,7
250173212002,1789,1321,59,0,80,0,221,108,1594,1214,46,0,80,0,164,90,195,107,13,0,0,0,57,18
250173212003,1659,1460,35,0,62,0,78,24,1529,1385,30,0,62,0,29,23,130,75,5,0,0,0,49,1
250173213001,1164,881,37,1,16,7,184,38,843,690,35,1,16,7,67,27,321,191,2,0,0,0,117,11
250173213002,880,690,23,2,10,0,116,39,664,587,21,2,10,0,29,15,216,103,2,0,0,0,87,24
250173213003,1363,992,66,4,31,0,212,58,1025,812,51,1,31,0,88,42,338,180,15,3,0,0,124,16
250173213004,1735,1526,45,0,80,2,47,35,1657,1480,45,0,78,2,20,32,78,46,0,0,2,0,27,3
250173213005,620,509,20,4,11,0,60,16,540,476,20,4,11,0,15,14,80,33,0,0,0,0,45,2
250173213006,1735,1302,72,7,29,3,226,96,1402,1157,58,4,29,0,80,74,333,145,14,3,0,3,146,22
250173214001,2398,2178,28,3,115,0,26,48,2323,2131,27,3,115,0,7,40,75,47,1,0,0,0,19,8
250173214002,899,740,22,3,71,0,49,14,813,697,19,2,71,0,15,9,86,43,3,1,0,0,34,5
250173215001,3571,2841,128,20,73,2,391,116,3017,2578,127,7,73,2,155,75,554,263,1,13,0,0,236,41
250173215002,1918,1422,47,18,24,11,322,74,1342,1131,46,5,24,5,85,46,576,291,1,13,0,6,237,28
250173215003,1409,1134,41,0,110,0,77,47,1314,1090,40,0,109,0,29,46,95,44,1,0,1,0,48,1
250173216001,3162,2529,77,5,235,0,235,81,2903,2390,74,4,235,0,138,62,259,139,3,1,0,0,97,19
250173216002,1327,1183,20,2,74,0,31,17,1278,1159,20,1,72,0,14,12,49,24,0,1,2,0,17,5
250173216003,1301,1142,25,0,53,0,43,38,1245,1108,25,0,53,0,24,35,56,34,0,0,0,0,19,3
250158209001,1321,1265,12,3,21,0,7,13,1291,1246,11,2,21,0,3,8,30,19,1,1,0,0,4,5
250158209002,1368,1310,7,0,18,0,10,23,1331,1285,6,0,18,0,0,22,37,25,1,0,0,0,10,1
250158209003,1707,1652,6,4,9,1,15,20,1673,1637,6,3,8,1,0,18,34,15,0,1,1,0,15,2
250158209004,1844,1794,0,8,21,0,8,13,1815,1773,0,8,21,0,1,12,29,21,0,0,0,0,7,1
250158210001,718,693,3,1,4,0,5,12,699,677,3,1,4,0,2,12,19,16,0,0,0,0,3,0
250158210002,946,908,11,0,17,0,6,4,919,888,11,0,17,0,0,3,27,20,0,0,0,0,6,1
250158210003,670,636,9,2,14,0,5,4,657,630,9,2,14,0,0,2,13,6,0,0,0,0,5,2
250158210004,1917,1834,22,3,19,0,16,23,1852,1791,22,2,19,0,2,16,65,43,0,1,0,0,14,7
250158211001,1419,1324,17,2,38,0,12,26,1368,1290,17,2,38,0,0,21,51,34,0,0,0,0,12,5
250158211002,1535,1391,34,5,24,7,42,32,1441,1336,32,5,24,7,15,22,94,55,2,0,0,0,27,10
250158211003,1247,1137,33,2,5,0,24,46,1164,1081,32,2,5,0,1,43,83,56,1,0,0,0,23,3
250158211004,2372,2258,17,1,41,0,19,36,2320,2236,12,1,40,0,2,29,52,22,5,0,1,0,17,7
250158211005,366,344,3,0,11,0,5,3,352,337,2,0,10,0,0,3,14,7,1,0,1,0,5,0
250158212001,2127,1385,178,3,405,2,39,115,1987,1308,166,1,403,2,6,101,140,77,12,2,2,0,33,14
250158213001,2119,1940,43,1,56,0,32,47,1986,1851,43,1,56,0,0,35,133,89,0,0,0,0,32,12
250158213002,1160,1050,20,1,56,0,10,23,1119,1023,18,1,56,0,1,20,41,27,2,0,0,0,9,3
250158213003,918,870,3,2,16,0,8,19,897,860,1,2,15,0,4,15,21,10,2,0,1,0,4,4
250158214001,1144,1057,25,0,28,1,15,18,1104,1034,24,0,28,1,3,14,40,23,1,0,0,0,12,4
250158214002,772,721,11,2,29,0,1,8,760,712,10,2,29,0,1,6,12,9,1,0,0,0,0,2
250158214003,1135,1084,8,3,29,0,4,7,1111,1066,8,3,29,0,0,5,24,18,0,0,0,0,4,2
250158214004,2199,1937,58,4,127,0,21,52,2112,1883,54,3,124,0,1,47,87,54,4,1,3,0,20,5
250158215001,956,932,3,3,7,0,5,6,946,927,3,3,6,0,3,4,10,5,0,0,1,0,2,2
250158215002,808,785,3,0,7,0,6,7,790,773,3,0,7,0,0,7,18,12,0,0,0,0,6,0
250158215003,1515,1479,16,0,3,0,6,11,1496,1468,16,0,3,0,1,8,19,11,0,0,0,0,5,3
250158216011,1708,1609,27,1,43,0,6,22,1658,1569,25,1,43,0,2,18,50,40,2,0,0,0,4,4
250158216012,1716,1252,96,7,180,0,110,71,1446,1143,84,5,174,0,6,34,270,109,12,2,6,0,104,37
250158216021,961,911,11,2,15,1,9,12,933,894,10,0,15,1,2,11,28,17,1,2,0,0,7,1
250158216022,1428,1143,76,10,32,4,99,64,1166,1032,56,6,31,0,4,37,262,111,20,4,1,4,95,27
250158216023,1455,1367,19,4,19,1,12,33,1416,1347,16,2,19,1,4,27,39,20,3,2,0,0,8,6
250158217001,2736,2556,19,8,62,0,42,49,2657,2516,18,7,62,0,7,47,79,40,1,1,0,0,35,2
250158217002,758,720,11,0,4,0,2,21,738,705,11,0,4,0,0,18,20,15,0,0,0,0,2,3
250158217003,231,178,43,4,0,1,2,3,219,170,42,3,0,1,0,3,12,8,1,1,0,0,2,0
250158219011,2430,2183,52,5,104,2,25,59,2348,2125,52,4,104,0,8,55,82,58,0,1,0,2,17,4
250158219012,861,741,23,3,36,1,31,26,814,724,23,2,36,1,4,24,47,17,0,1,0,0,27,2
250158219031,1303,1143,50,4,23,0,42,41,1167,1073,38,3,22,0,2,29,136,70,12,1,1,0,40,12
250158219032,249,148,37,5,4,0,50,5,186,137,36,4,4,0,1,4,63,11,1,1,0,0,49,1
250158219033,1873,1631,44,5,69,0,88,36,1684,1543,40,3,68,0,4,26,189,88,4,2,1,0,84,10
250158219041,979,887,7,4,24,0,38,19,920,868,6,2,24,0,2,18,59,19,1,2,0,0,36,1
250158219042,1785,1590,38,5,55,0,38,59,1697,1533,37,5,55,0,17,50,88,57,1,0,0,0,21,9
250158220001,1962,1368,141,4,292,0,44,113,1811,1292,129,2,290,0,10,88,151,76,12,2,2,0,34,25
250158222001,886,833,19,1,10,0,8,15,852,812,17,1,9,0,5,8,34,21,2,0,1,0,3,7
250158222002,2349,2160,22,9,57,0,40,61,2142,2016,22,7,55,0,2,40,207,144,0,2,2,0,38,21
250158222003,2879,2605,41,2,133,4,22,72,2767,2531,38,2,133,3,4,56,112,74,3,0,0,1,18,16
250158223001,2086,1944,18,0,47,3,34,40,1993,1893,17,0,47,3,1,32,93,51,1,0,0,0,33,8
250158223002,1387,1292,17,2,47,0,8,21,1347,1264,17,2,47,0,1,16,40,28,0,0,0,0,7,5
250158223003,787,747,10,0,8,0,8,14,764,733,9,0,8,0,2,12,23,14,1,0,0,0,6,2
250158223004,1112,1043,9,6,23,0,23,8,1045,997,9,6,23,0,2,8,67,46,0,0,0,0,21,0
250158224011,1804,1754,3,1,13,0,3,30,1787,1742,3,1,13,0,0,28,17,12,0,0,0,0,3,2
250158224012,1529,1471,6,8,26,0,7,11,1501,1451,6,8,25,0,0,11,28,20,0,0,1,0,7,0
250158224013,1405,1362,9,1,19,0,6,8,1380,1343,9,1,19,0,1,7,25,19,0,0,0,0,5,1
250158224014,1104,999,21,1,51,0,10,22,1057,967,19,1,51,0,2,17,47,32,2,0,0,0,8,5
250158224021,2209,1992,47,5,64,1,48,52,2067,1919,40,5,64,0,0,39,142,73,7,0,0,1,48,13
250158224022,643,567,16,0,19,0,19,22,606,557,14,0,18,0,2,15,37,10,2,0,1,0,17,7
250158224023,1070,982,13,6,41,0,13,15,1021,953,13,6,41,0,0,8,49,29,0,0,0,0,13,7
250158224024,917,873,5,1,22,0,4,12,895,858,4,1,22,0,2,8,22,15,1,0,0,0,2,4
250158225001,957,929,1,0,6,0,3,18,940,919,1,0,6,0,0,14,17,10,0,0,0,0,3,4
250158225002,1227,1201,2,0,7,0,2,15,1217,1194,2,0,7,0,1,13,10,7,0,0,0,0,1,2
250158225003,1375,1317,10,2,14,0,10,22,1345,1307,8,2,13,0,0,15,30,10,2,0,1,0,10,7
250158225004,2233,2191,9,3,6,0,10,14,2205,2173,9,3,6,0,2,12,28,18,0,0,0,0,8,2
250158226011,1279,1242,5,1,1,2,5,23,1254,1228,3,1,1,2,0,19,25,14,2,0,0,0,5,4
250158226012,901,872,4,4,2,0,2,17,885,862,1,4,2,0,0,16,16,10,3,0,0,0,2,1
250158226031,1607,1576,3,2,8,0,5,13,1577,1558,2,1,8,0,2,6,30,18,1,1,0,0,3,7
250158226051,1222,1199,2,1,5,1,3,11,1204,1189,1,1,5,1,0,7,18,10,1,0,0,0,3,4
250158226061,1054,1029,3,3,3,0,2,14,1042,1022,3,3,3,0,0,11,12,7,0,0,0,0,2,3
250158226062,957,926,0,0,4,0,13,14,941,916,0,0,4,0,8,13,16,10,0,0,0,0,5,1
250158226063,1525,1479,8,2,16,0,1,19,1492,1453,8,0,16,0,0,15,33,26,0,2,0,0,1,4
250158227001,648,624,14,1,4,0,2,3,639,617,14,1,4,0,0,3,9,7,0,0,0,0,2,0
250158227002,872,853,3,0,1,0,6,9,860,844,3,0,1,0,3,9,12,9,0,0,0,0,3,0
250158227003,1677,1631,1,0,22,0,1,22,1661,1617,1,0,22,0,0,21,16,14,0,0,0,0,1,1
250173001001,1618,1565,12,4,4,1,7,25,1594,1554,9,1,4,1,2,23,24,11,3,3,0,0,5,2
250173001002,1456,1421,0,1,6,0,4,24,1423,1400,0,1,6,0,0,16,33,21,0,0,0,0,4,8
250173011011,1886,1802,16,6,26,0,11,25,1849,1776,15,5,26,0,4,23,37,26,1,1,0,0,7,2
250138019022,1270,489,337,11,5,4,367,57,603,257,306,2,4,4,3,27,667,232,31,9,1,0,364,30
250138019023,710,245,203,1,43,0,187,31,317,78,172,1,43,0,2,21,393,167,31,0,0,0,185,10
250138020001,2174,863,378,29,34,1,752,117,701,339,296,4,34,0,3,25,1473,524,82,25,0,1,749,92
250138020002,675,234,95,3,2,1,312,28,109,40,62,0,0,0,3,4,566,194,33,3,2,1,309,24
250138021001,1503,572,380,17,13,0,438,83,704,311,329,3,13,0,10,38,799,261,51,14,0,0,428,45
250138021002,664,457,82,1,5,0,98,21,491,394,75,0,5,0,3,14,173,63,7,1,0,0,95,7
250138021003,816,679,50,0,20,1,31,35,748,655,47,0,19,0,10,17,68,24,3,0,1,1,21,18
250138021004,1063,540,173,7,30,1,254,58,652,434,146,2,30,0,9,31,411,106,27,5,0,1,245,27
250138021005,721,507,81,0,30,0,79,24,524,420,70,0,30,0,0,4,197,87,11,0,0,0,79,20
250138021006,1308,779,267,1,72,0,150,39,986,642,240,1,72,0,6,25,322,137,27,0,0,0,144,14
250138022001,987,348,220,2,67,0,284,66,422,139,188,1,67,0,0,27,565,209,32,1,0,0,284,39
250138022002,1159,444,248,7,27,0,376,57,488,224,198,0,27,0,2,37,671,220,50,7,0,0,374,20
250138022003,1162,444,247,22,182,0,229,38,681,249,221,9,181,0,4,17,481,195,26,13,1,0,225,21
250138023001,737,302,188,7,33,1,166,40,363,169,145,4,33,1,0,11,374,133,43,3,0,0,166,29
250138023002,1805,847,414,14,133,1,296,100,994,479,342,0,132,1,1,39,811,368,72,14,1,0,295,61
250138023003,2469,745,581,4,222,5,778,134,1116,365,488,1,222,0,1,39,1353,380,93,3,0,5,777,95
250138023004,839,318,179,4,81,1,219,37,414,158,156,4,81,0,1,14,425,160,23,0,0,1,218,23
250138023005,988,345,187,13,110,7,260,66,497,198,160,6,110,0,0,23,491,147,27,7,0,7,260,43
250138024001,752,616,70,1,34,0,6,25,713,590,69,1,33,0,2,18,39,26,1,0,1,0,4,7
250138024002,714,641,40,3,17,0,4,9,682,622,33,1,17,0,0,9,32,19,7,2,0,0,4,0
250138024003,1380,1147,103,0,56,0,38,36,1223,1063,90,0,53,0,0,17,157,84,13,0,3,0,38,19
250138024004,698,526,97,1,44,0,6,24,626,478,86,0,44,0,1,17,72,48,11,1,0,0,5,7
250138025001,912,771,73,1,37,0,11,19,834,711,72,1,34,0,1,15,78,60,1,0,3,0,10,4
250138025002,1087,885,85,1,41,0,40,35,988,844,81,0,41,0,2,20,99,41,4,1,0,0,38,15
250138025003,1007,774,103,1,59,0,37,33,870,697,95,1,59,0,0,18,137,77,8,0,0,0,37,15
250138025004,1015,826,62,0,51,0,41,35,910,779,54,0,51,0,0,26,105,47,8,0,0,0,41,9
250138025005,1277,1044,131,1,23,0,34,44,1112,950,114,1,23,0,0,24,165,94,17,0,0,0,34,20
250138025006,1396,936,237,2,68,0,103,50,1163,843,222,1,68,0,3,26,233,93,15,1,0,0,100,24
250138026011,655,484,68,1,22,0,59,21,533,446,56,1,22,0,0,8,122,38,12,0,0,0,59,13
250138026012,1391,733,297,8,77,0,222,54,903,532,268,7,70,0,2,24,488,201,29,1,7,0,220,30
250138026013,1319,649,301,5,71,0,232,61,878,511,274,5,71,0,0,17,441,138,27,0,0,0,232,44
250138026014,1291,515,333,11,108,0,242,82,800,346,292,6,108,0,0,48,491,169,41,5,0,0,242,34
250138026015,1164,644,157,8,102,0,202,51,797,520,139,5,102,0,2,29,367,124,18,3,0,0,200,22
250138026016,1218,793,166,8,89,4,113,45,978,703,158,7,85,4,0,21,240,90,8,1,4,0,113,24
250138026021,1902,1642,92,2,64,1,58,43,1757,1574,87,0,64,1,0,31,145,68,5,2,0,0,58,12
250138101001,2493,2399,20,0,20,0,24,30,2433,2375,19,0,20,0,0,19,60,24,1,0,0,0,24,11
250138101002,1091,1032,19,4,7,0,1,28,1065,1013,19,3,7,0,0,23,26,19,0,1,0,0,1,5
250138101003,1774,1698,30,9,13,0,3,21,1727,1665,24,9,13,0,0,16,47,33,6,0,0,0,3,5
250138101004,932,863,11,0,31,0,7,20,904,848,10,0,31,0,0,15,28,15,1,0,0,0,7,5
250138102001,944,897,16,1,2,0,9,19,924,892,12,1,2,0,4,13,20,5,4,0,0,0,5,6
250138102002,1112,1077,5,4,5,0,1,20,1091,1063,5,4,5,0,0,14,21,14,0,0,0,0,1,6
250138102003,654,636,1,0,2,0,5,10,639,629,0,0,2,0,0,8,15,7,1,0,0,0,5,2
250138103001,1293,1224,17,5,18,0,11,18,1263,1214,16,2,18,0,0,13,30,10,1,3,0,0,11,5
250138103002,1847,1773,18,1,9,0,10,36,1803,1747,17,1,9,0,2,27,44,26,1,0,0,0,8,9
250138104031,1285,1173,18,0,18,1,37,38,1205,1132,18,0,18,1,9,27,80,41,0,0,0,0,28,11
250138104032,1636,1500,27,6,14,0,37,52,1539,1450,25,2,14,0,5,43,97,50,2,4,0,0,32,9
250138104033,1010,959,15,0,1,3,13,19,965,935,11,0,1,3,0,15,45,24,4,0,0,0,13,4
250138104041,1068,1008,6,0,12,1,18,23,1030,988,6,0,12,1,4,19,38,20,0,0,0,0,14,4
250138104042,2693,2565,34,2,22,3,42,25,2586,2506,26,2,22,3,5,22,107,59,8,0,0,0,37,3
250138104121,2442,2380,11,0,22,0,2,27,2413,2355,11,0,22,0,1,24,29,25,0,0,0,0,1,3
250138104122,1881,1830,15,1,4,0,17,14,1832,1791,13,1,4,0,10,13,49,39,2,0,0,0,7,1
250138104123,1610,1562,2,2,26,0,6,12,1595,1548,2,2,26,0,5,12,15,14,0,0,0,0,1,0
250138104141,2413,1923,358,9,21,0,78,24,1811,1420,353,2,20,0,1,15,602,503,5,7,1,0,77,9
250138104142,1672,1630,7,5,14,0,3,13,1647,1609,5,5,14,0,3,11,25,21,2,0,0,0,0,2
250138104143,3393,3298,21,0,17,0,18,39,3297,3229,15,0,17,0,2,34,96,69,6,0,0,0,16,5
250138106011,806,766,11,1,8,0,11,9,764,740,10,1,8,0,1,4,42,26,1,0,0,0,10,5
250138106012,2403,2048,117,6,59,5,126,42,2086,1898,93,2,59,5,5,24,317,150,24,4,0,0,121,18
250138106013,1058,928,24,4,23,3,50,26,950,877,20,4,23,3,7,16,108,51,4,0,0,0,43,10
250138106021,2657,2543,25,6,36,2,18,27,2594,2507,21,3,36,2,0,25,63,36,4,3,0,0,18,2
250138107001,1577,1445,33,4,18,0,54,23,1454,1388,30,4,18,0,1,13,123,57,3,0,0,0,53,10
250138107002,827,768,15,3,1,0,26,14,774,752,11,1,1,0,0,9,53,16,4,2,0,0,26,5
250138107003,1427,1115,86,5,12,2,142,65,1150,1021,68,3,12,1,6,39,277,94,18,2,0,1,136,26
250138107004,927,862,20,1,7,0,18,19,855,815,15,1,7,0,1,16,72,47,5,0,0,0,17,3
250138107005,1393,1216,31,3,33,0,77,33,1217,1132,24,3,33,0,0,25,176,84,7,0,0,0,77,8
250138108001,1494,1325,53,6,11,2,51,46,1347,1259,42,4,11,2,5,24,147,66,11,2,0,0,46,22
250138108002,1293,926,77,3,5,0,223,59,836,748,57,0,5,0,0,26,457,178,20,3,0,0,223,33
250138108003,1036,963,31,0,8,0,30,4,952,917,24,0,8,0,0,3,84,46,7,0,0,0,30,1
250138109011,1948,1417,116,6,18,0,313,78,1323,1157,83,4,18,0,31,30,625,260,33,2,0,0,282,48
250138109021,1446,1348,35,2,15,0,27,19,1362,1308,22,2,15,0,3,12,84,40,13,0,0,0,24,7
250138109022,678,616,4,2,7,0,41,8,610,588,4,2,7,0,2,7,68,28,0,0,0,0,39,1
250138109023,1483,1271,80,5,6,0,91,30,1265,1169,72,5,6,0,0,13,218,102,8,0,0,0,91,17
250138109024,971,587,61,3,6,0,252,62,489,427,31,1,6,0,0,24,482,160,30,2,0,0,252,38
250138110001,973,881,20,4,16,0,38,14,850,805,15,3,16,0,0,11,123,76,5,1,0,0,38,3
250138110002,702,668,10,0,4,0,14,6,655,637,10,0,4,0,0,4,47,31,0,0,0,0,14,2
250138110003,948,879,14,2,14,0,13,26,901,855,13,2,14,0,0,17,47,24,1,0,0,0,13,9
250138110004,1049,989,24,0,14,0,10,12,978,931,22,0,14,0,0,11,71,58,2,0,0,0,10,1
250138110005,950,930,6,1,5,0,3,5,919,904,5,0,5,0,0,5,31,26,1,1,0,0,3,0
250138111011,1529,1149,84,22,26,3,196,49,887,772,49,2,26,0,6,32,642,377,35,20,0,3,190,17
250138111012,1361,1128,47,12,20,0,130,24,998,934,28,4,16,0,6,10,363,194,19,8,4,0,124,14
250138111013,1426,1298,47,6,24,0,27,24,1228,1179,14,1,24,0,0,10,198,119,33,5,0,0,27,14
250138111014,742,643,25,14,1,2,42,15,590,552,23,3,1,2,0,9,152,91,2,11,0,0,42,6
250138111021,1487,993,157,32,6,6,222,71,829,717,75,1,5,1,5,25,658,276,82,31,1,5,217,46
250138111022,2047,1485,147,6,29,0,281,99,1144,1014,70,3,26,0,0,31,903,471,77,3,3,0,281,68
250138111023,1452,1380,17,1,15,0,20,19,1360,1315,16,0,15,0,0,14,92,65,1,1,0,0,20,5
250138111024,1114,978,21,3,22,4,66,20,909,860,13,2,22,0,1,11,205,118,8,1,0,4,65,9
250138112001,1667,1561,38,1,22,0,18,27,1590,1514,33,0,22,0,0,21,77,47,5,1,0,0,18,6
250138112002,1233,1113,20,3,26,0,47,24,1132,1072,16,1,26,0,2,15,101,41,4,2,0,0,45,9
250138112003,976,884,13,5,21,1,17,35,905,854,8,3,21,0,0,19,71,30,5,2,0,1,17,16
250138112004,983,896,25,1,15,0,13,33,898,833,22,1,15,0,0,27,85,63,3,0,0,0,13,6
250138113011,1368,1231,26,1,22,0,76,12,1194,1147,17,1,22,0,1,6,174,84,9,0,0,0,75,6
250138113012,776,734,9,0,8,1,10,14,734,703,9,0,8,1,2,11,42,31,0,0,0,0,8,3
250138113013,2236,1995,75,10,51,0,56,49,2051,1888,66,8,50,0,7,32,185,107,9,2,1,0,49,17
250138113014,1114,1011,26,0,16,1,48,12,1004,957,19,0,16,1,0,11,110,54,7,0,0,0,48,1
250138113021,0,0,0,0,0,0,0,0,0,0,0,0,0,0,0,0,0,0,0,0,0,0,0,0
250138113022,1419,1304,42,5,29,0,21,18,1329,1254,30,4,26,0,1,14,90,50,12,1,3,0,20,4
250138113023,1303,883,288,10,15,3,68,36,1088,769,277,4,15,3,2,18,215,114,11,6,0,0,66,18
250138113024,1406,1316,20,1,27,1,22,19,1330,1266,20,1,24,1,0,18,76,50,0,0,3,0,22,1
250138113025,1613,1526,33,4,16,0,8,26,1571,1503,28,3,16,0,0,21,42,23,5,1,0,0,8,5
250138114001,1016,400,61,12,0,0,484,59,142,109,19,0,0,0,2,12,874,291,42,12,0,0,482,47
250138114002,1431,675,39,49,2,0,605,61,98,79,7,3,1,0,0,8,1333,596,32,46,1,0,605,53
250138115001,1182,478,121,7,1,12,466,97,101,56,39,0,1,0,1,4,1081,422,82,7,0,12,465,93
250138115002,1095,447,79,18,0,0,484,67,116,80,25,0,0,0,6,5,979,367,54,18,0,0,478,62
250138116001,910,327,64,8,6,0,445,60,84,54,15,0,6,0,0,9,826,273,49,8,0,0,445,51
250138116002,1026,436,66,8,2,2,466,46,153,101,41,1,2,0,0,8,873,335,25,7,0,2,466,38
250138116003,654,280,61,9,6,0,275,23,140,108,24,2,3,0,0,3,514,172,37,7,3,0,275,20
250138116004,1159,410,83,22,11,0,526,107,142,98,27,2,9,0,0,6,1017,312,56,20,2,0,526,101
250138117001,481,385,7,3,4,0,72,10,292,281,7,0,1,0,0,3,189,104,0,3,3,0,72,7
250138117002,1016,512,61,17,13,2,360,51,198,156,14,4,13,0,0,11,818,356,47,13,0,2,360,40
250138117003,532,200,36,4,8,0,233,51,96,66,12,0,8,0,3,7,436,134,24,4,0,0,230,44
250138118001,717,351,42,8,4,0,277,35,180,137,18,5,4,0,2,14,537,214,24,3,0,0,275,21
250138118002,781,348,38,0,4,0,355,36,172,142,21,0,4,0,1,4,609,206,17,0,0,0,354,32
250138118003,1109,694,71,1,8,0,301,34,564,499,42,1,8,0,1,13,545,195,29,0,0,0,300,21
250138118004,633,451,34,17,9,0,108,14,372,341,17,0,9,0,0,5,261,110,17,17,0,0,108,9
250138118005,899,648,32,6,4,1,165,43,487,446,12,1,3,0,1,24,412,202,20,5,1,1,164,19
250138119001,1340,1172,36,4,14,1,72,41,1131,1064,25,4,14,0,0,24,209,108,11,0,0,1,72,17
250138119002,1097,1002,20,0,20,0,43,12,993,948,16,0,20,0,0,9,104,54,4,0,0,0,43,3
250138119003,1118,1044,18,3,25,0,16,12,1043,987,16,3,25,0,1,11,75,57,2,0,0,0,15,1
250138120011,1073,530,65,21,7,0,397,53,313,257,37,0,7,0,1,11,760,273,28,21,0,0,396,42
250138120012,755,447,78,0,12,0,197,21,357,297,42,0,7,0,3,8,398,150,36,0,5,0,194,13
250138120013,869,530,76,2,7,0,207,47,386,326,30,0,7,0,0,23,483,204,46,2,0,0,207,24
250138120014,754,656,17,1,20,1,49,10,621,594,2,0,20,0,1,4,133,62,15,1,0,1,48,6
250138120021,2346,1500,95,23,15,0,631,82,1013,932,44,3,13,0,3,18,1333,568,51,20,2,0,628,64
250138120022,714,609,55,0,10,2,30,8,638,575,48,0,10,2,0,3,76,34,7,0,0,0,30,5
250138120023,703,483,30,3,17,0,148,22,385,342,14,0,14,0,4,11,318,141,16,3,3,0,144,11
250138120024,883,703,38,5,7,0,104,26,639,596,26,0,6,0,0,11,244,107,12,5,1,0,104,15
250138121011,836,779,11,0,9,0,18,19,783,748,11,0,6,0,3,15,53,31,0,0,3,0,15,4
250138121012,2175,2004,39,2,19,0,76,35,2008,1917,36,0,19,0,8,28,167,87,3,2,0,0,68,7
250138121013,893,850,12,3,3,0,24,1,827,809,12,3,3,0,0,0,66,41,0,0,0,0,24,1
250138121014,1202,1124,20,3,10,0,24,21,1123,1074,19,0,10,0,5,15,79,50,1,3,0,0,19,6
250138121031,867,591,43,2,1,1,194,35,428,376,27,2,1,1,0,21,439,215,16,0,0,0,194,14
250138121032,2969,1886,157,17,69,0,703,137,1631,1406,107,2,67,0,2,47,1338,480,50,15,2,0,701,90
250138121041,1395,912,49,8,16,4,334,72,724,640,31,6,16,4,7,20,671,272,18,2,0,0,327,52
250138121042,1390,900,55,14,22,1,334,64,706,632,39,1,22,0,0,12,684,268,16,13,0,1,334,52
250138121043,698,603,23,0,10,0,49,13,580,550,17,0,10,0,1,2,118,53,6,0,0,0,48,11
250138121044,1162,962,35,1,33,0,102,29,901,828,22,0,33,0,5,13,261,134,13,1,0,0,97,16
250138122011,2112,1889,60,2,57,3,60,41,1955,1798,56,2,56,3,4,36,157,91,4,0,1,0,56,5
250138122012,1220,875,86,5,150,0,60,44,1023,765,73,5,149,0,0,31,197,110,13,0,1,0,60,13
250138122013,1268,1125,18,1,55,0,42,27,1185,1091,17,1,55,0,6,15,83,34,1,0,0,0,36,12
250138122021,2215,1629,213,7,108,3,182,73,1865,1502,205,5,108,3,10,32,350,127,8,2,0,0,172,41
250138122022,857,697,52,4,44,0,49,11,762,656,51,2,44,0,1,8,95,41,1,2,0,0,48,3
250138122023,971,882,20,0,31,0,19,19,905,842,18,0,31,0,0,14,66,40,2,0,0,0,19,5
250138123001,1203,826,71,10,150,0,93,53,993,753,53,2,148,0,0,37,210,73,18,8,2,0,93,16
250173394002,626,540,20,2,25,0,21,18,594,526,20,2,25,0,4,17,32,14,0,0,0,0,17,1
250173394003,785,660,30,0,39,0,28,28,730,635,28,0,39,0,5,23,55,25,2,0,0,0,23,5
250173394004,882,762,44,0,51,0,11,14,845,736,41,0,51,0,8,9,37,26,3,0,0,0,3,5
250173395001,2710,2196,90,0,284,0,37,103,2595,2110,86,0,283,0,22,94,115,86,4,0,1,0,15,9
250173395002,1312,1006,120,5,56,0,74,51,1238,956,117,5,56,0,56,48,74,50,3,0,0,0,18,3
250173395003,641,507,79,1,34,0,4,16,612,490,75,1,34,0,2,10,29,17,4,0,0,0,2,6
250173395004,736,646,34,2,35,0,4,15,718,629,34,2,35,0,4,14,18,17,0,0,0,0,0,1
250173396001,797,664,34,0,50,0,29,20,753,640,33,0,47,0,14,19,44,24,1,0,3,0,15,1
250173396002,813,690,43,1,53,0,13,13,781,664,42,1,53,0,9,12,32,26,1,0,0,0,4,1
250173396003,757,607,52,0,69,0,4,25,740,596,52,0,69,0,1,22,17,11,0,0,0,0,3,3
250173396004,827,639,81,1,29,0,42,35,774,618,79,1,29,0,19,28,53,21,2,0,0,0,23,7
250173396005,885,620,118,3,73,0,55,16,817,594,106,1,73,0,28,15,68,26,12,2,0,0,27,1
250173396006,945,645,157,7,27,1,72,36,887,625,155,1,27,1,54,24,58,20,2,6,0,0,18,12
250173397001,552,446,24,2,33,0,18,29,516,428,20,0,33,0,13,22,36,18,4,2,0,0,5,7
250173397002,1678,959,381,1,173,0,90,74,1565,904,368,1,172,0,62,58,113,55,13,0,1,0,28,16
250173397003,785,648,64,3,29,0,28,13,745,622,64,1,29,0,22,7,40,26,0,2,0,0,6,6
250173397004,863,628,98,1,45,0,61,30,771,585,95,1,45,0,21,24,92,43,3,0,0,0,40,6
250173398011,2101,1381,103,9,551,0,26,31,2013,1322,97,8,551,0,11,24,88,59,6,1,0,0,15,7
250173398012,617,389,46,2,136,0,35,9,590,378,43,2,136,0,28,3,27,11,3,0,0,0,7,6
250173398013,808,492,59,0,148,0,85,24,741,468,59,0,147,0,51,16,67,24,0,0,1,0,34,8
250173398014,884,623,91,0,111,0,42,17,847,613,86,0,111,0,22,15,37,10,5,0,0,0,20,2
250173398021,1308,973,76,2,197,2,24,34,1241,923,70,2,197,2,14,33,67,50,6,0,0,0,10,1
250173398022,2498,1496,560,16,221,1,118,86,2314,1431,539,10,221,1,35,77,184,65,21,6,0,0,83,9
250173398023,751,575,81,1,66,0,11,17,717,550,78,1,66,0,6,16,34,25,3,0,0,0,5,1
250173399001,1651,1322,117,2,82,2,82,44,1572,1261,115,1,82,2,72,39,79,61,2,1,0,0,10,5
250173399002,950,767,75,0,31,0,39,38,888,741,69,0,31,0,21,26,62,26,6,0,0,0,18,12
250173399003,939,788,77,5,36,0,14,19,893,761,73,5,36,0,4,14,46,27,4,0,0,0,10,5
250173399004,759,517,103,0,44,0,84,11,713,483,103,0,44,0,72,11,46,34,0,0,0,0,12,0
250173399005,872,699,65,2,43,0,44,19,842,690,64,2,43,0,28,15,30,9,1,0,0,0,16,4
250173400001,1033,670,201,3,48,0,71,40,964,636,195,2,48,0,53,30,69,34,6,1,0,0,18,10
250173400002,848,669,81,0,41,0,28,29,812,643,81,0,41,0,18,29,36,26,0,0,0,0,10,0
250173400003,713,540,61,1,38,0,39,34,655,514,59,1,38,0,16,27,58,26,2,0,0,0,23,7
250173401001,760,667,20,1,51,0,8,13,743,656,20,1,51,0,2,13,17,11,0,0,0,0,6,0
250173401002,1047,935,24,2,61,0,19,6,1016,920,24,0,61,0,7,4,31,15,0,2,0,0,12,2
250173401003,1611,1408,49,3,101,0,15,35,1597,1402,49,3,101,0,11,31,14,6,0,0,0,0,4,4
250173401004,1483,1182,114,1,109,0,27,50,1420,1158,111,0,107,0,12,32,63,24,3,1,2,0,15,18
250173401005,925,856,37,1,24,0,2,5,900,840,30,1,24,0,0,5,25,16,7,0,0,0,2,0
250173401006,826,695,56,0,51,0,8,16,816,690,56,0,51,0,3,16,10,5,0,0,0,0,5,0
250173411011,1574,909,154,2,442,0,34,33,1484,866,145,0,439,0,12,22,90,43,9,2,3,0,22,11
250173411012,768,374,85,0,290,0,11,8,748,366,78,0,290,0,7,7,20,8,7,0,0,0,4,1
250173411013,1333,1008,77,0,176,0,22,50,1283,982,76,0,176,0,5,44,50,26,1,0,0,0,17,6
250173411021,1346,651,131,1,473,0,52,38,1259,613,130,1,472,0,19,24,87,38,1,0,1,0,33,14
250173411022,780,503,74,0,181,0,12,10,748,482,74,0,177,0,5,10,32,21,0,0,4,0,7,0
250173411023,1063,540,146,1,297,0,45,34,998,512,145,1,292,0,17,31,65,28,1,0,5,0,28,3
250173411024,557,379,51,1,110,0,8,8,539,368,50,1,110,0,3,7,18,11,1,0,0,0,5,1
250173411025,818,648,56,0,82,0,9,23,779,621,56,0,81,0,2,19,39,27,0,0,1,0,7,4
250173412001,1164,517,71,0,511,0,42,23,1093,481,69,0,511,0,11,21,71,36,2,0,0,0,31,2
250173412002,976,509,119,1,266,0,51,30,904,472,117,1,261,0,31,22,72,37,2,0,5,0,20,8
250173412003,1070,564,230,0,180,0,60,36,1006,531,225,0,179,0,41,30,64,33,5,0,1,0,19,6
250173412004,978,647,114,0,127,1,68,21,890,622,104,0,120,1,35,8,88,25,10,0,7,0,33,13
250173412005,1693,1031,138,3,400,0,85,36,1616,999,136,3,400,0,50,28,77,32,2,0,0,0,35,8
250173412006,976,499,128,1,270,0,51,27,909,464,128,1,264,0,29,23,67,35,0,0,6,0,22,4
250173413001,2158,1021,345,0,679,1,62,50,2068,978,342,0,679,0,24,45,90,43,3,0,0,1,38,5
250173413002,922,410,115,3,338,0,19,37,865,380,103,2,338,0,6,36,57,30,12,1,0,0,13,1
250173413003,2359,866,240,7,1083,2,64,97,2282,816,236,7,1083,1,46,93,77,50,4,0,0,1,18,4
250173414001,1085,521,204,6,253,0,65,36,964,451,197,3,252,0,41,20,121,70,7,3,1,0,24,16
250173414002,944,442,232,1,178,0,63,28,842,404,225,1,178,0,15,19,102,38,7,0,0,0,48,9
250173414003,1802,1042,332,3,234,0,109,82,1595,946,320,3,231,0,44,51,207,96,12,0,3,0,65,31
250173414004,1612,955,262,3,164,0,173,55,1417,873,248,3,158,0,95,40,195,82,14,0,6,0,78,15
250173414005,769,499,112,1,77,1,31,48,686,453,102,1,77,1,16,36,83,46,10,0,0,0,15,12
250173415001,958,509,206,4,154,1,33,51,857,458,201,1,154,1,3,39,101,51,5,3,0,0,30,12
250173415002,749,360,149,6,164,0,60,10,651,318,148,6,159,0,14,6,98,42,1,0,5,0,46,4
250173415003,1070,490,213,0,220,0,117,30,886,399,209,0,220,0,34,24,184,91,4,0,0,0,83,6
250173415004,775,315,243,0,98,0,94,25,669,285,235,0,96,0,35,18,106,30,8,0,2,0,59,7
250173415005,1228,488,313,3,277,0,119,28,1051,397,307,1,277,0,46,23,177,91,6,2,0,0,73,5
250173416001,739,524,94,0,87,0,21,13,714,509,94,0,87,0,12,12,25,15,0,0,0,0,9,1
250173416002,994,823,84,1,55,0,9,22,962,798,84,1,55,0,5,19,32,25,0,0,0,0,4,3
250173416003,1175,793,168,0,154,0,26,34,1114,746,167,0,154,0,15,32,61,47,1,0,0,0,11,2
250173416004,1236,563,257,7,250,3,49,107,1143,514,253,7,250,3,23,93,93,49,4,0,0,0,26,14
250173416005,862,445,148,1,214,0,35,19,804,422,134,1,214,0,21,12,58,23,14,0,0,0,14,7
250173416006,1558,834,173,5,434,0,72,40,1459,781,165,3,434,0,39,37,99,53,8,2,0,0,33,3
250173417001,875,618,107,2,67,0,39,42,746,534,102,0,67,0,11,32,129,84,5,2,0,0,28,10
250173417002,1332,911,251,5,79,1,41,44,1192,825,229,2,79,1,22,34,140,86,22,3,0,0,19,10
250173417003,1182,859,184,0,106,0,17,16,1114,808,176,0,105,0,13,12,68,51,8,0,1,0,4,4
250173417004,1239,883,174,0,131,0,24,27,1140,819,172,0,131,0,7,11,99,64,2,0,0,0,17,16
250173417005,670,471,88,0,73,0,8,30,633,453,83,0,73,0,2,22,37,18,5,0,0,0,6,8
250173418001,1080,676,191,0,72,1,87,53,928,598,187,0,72,1,31,39,152,78,4,0,0,0,56,14
250173418002,1447,709,423,5,151,0,79,80,1270,638,407,4,146,0,8,67,177,71,16,1,5,0,71,13
250173418003,677,386,130,1,111,0,24,25,626,352,128,1,111,0,13,21,51,34,2,0,0,0,11,4
250173418004,810,443,116,3,137,0,62,49,719,406,115,3,137,0,18,40,91,37,1,0,0,0,44,9
250173418005,1456,606,259,2,457,0,83,49,1303,538,253,2,450,0,29,31,153,68,6,0,7,0,54,18
250173418006,1084,608,194,0,128,1,128,25,884,515,190,0,127,1,30,21,200,93,4,0,1,0,98,4
250173419011,674,447,114,0,65,0,30,18,636,425,110,0,64,0,24,13,38,22,4,0,1,0,6,5
250173419012,713,485,58,0,105,0,29,36,624,429,55,0,105,0,5,30,89,56,3,0,0,0,24,6
250173419021,1629,984,187,2,276,0,136,44,1483,922,181,1,276,0,69,34,146,62,6,1,0,0,67,10
250173419022,845,626,102,0,58,0,39,20,756,569,96,0,58,0,18,15,89,57,6,0,0,0,21,5
250173419023,1082,697,147,5,210,0,16,7,1025,664,143,3,206,0,2,7,57,33,4,2,4,0,14,0
250173419024,824,462,97,7,191,0,52,15,732,415,92,7,191,0,15,12,92,47,5,0,0,0,37,3
250173419025,1517,1056,174,3,150,3,71,60,1377,1007,147,1,150,3,18,51,140,49,27,2,0,0,53,9
250173419026,2223,1085,336,8,486,1,208,99,1985,987,314,4,482,1,114,83,238,98,22,4,4,0,94,16
250173421011,1483,970,157,9,39,3,247,58,1022,744,150,1,38,3,50,36,461,226,7,8,1,0,197,22
250173421012,1067,717,175,0,43,0,106,26,891,623,160,0,42,0,45,21,176,94,15,0,1,0,61,5
250173421013,964,659,135,5,48,0,80,37,860,630,134,5,46,0,25,20,104,29,1,0,2,0,55,17
250173421014,943,637,142,8,48,0,79,29,787,566,133,7,45,0,15,21,156,71,9,1,3,0,64,8
250173421021,910,624,129,2,20,0,97,38,802,579,119,2,20,0,54,28,108,45,10,0,0,0,43,10
250173421022,938,637,114,9,28,0,116,34,736,545,111,3,28,0,27,22,202,92,3,6,0,0,89,12
250173421023,966,712,141,9,33,3,47,21,843,631,136,4,33,0,22,17,123,81,5,5,0,3,25,4
250173421024,1252,716,291,7,59,0,112,67,996,594,277,7,59,0,22,37,256,122,14,0,0,0,90,30
250173422011,2830,1748,503,15,91,1,327,145,2229,1466,475,6,90,1,100,91,601,282,28,9,1,0,227,54
250173422012,2438,1534,482,13,93,0,265,51,1932,1285,449,10,91,0,73,24,506,249,33,3,2,0,192,27
250173422021,2517,1538,379,10,173,0,322,95,1964,1287,353,2,172,0,89,61,553,251,26,8,1,0,233,34
250173422022,1316,984,143,3,70,0,86,30,1151,886,134,1,70,0,38,22,165,98,9,2,0,0,48,8
250173423001,1327,904,148,3,50,0,171,51,1107,811,137,3,49,0,72,35,220,93,11,0,1,0,99,16
250173423002,1555,929,187,8,68,0,296,67,1196,796,184,8,68,0,90,50,359,133,3,0,0,0,206,17
250173423003,2137,1357,298,4,60,0,331,87,1687,1174,291,2,60,0,115,45,450,183,7,2,0,0,216,42
250173423004,1807,1122,243,2,98,0,266,76,1491,1024,230,2,98,0,84,53,316,98,13,0,0,0,182,23
250173424001,1878,1137,253,4,114,0,278,92,1561,1021,238,1,114,0,125,62,317,116,15,3,0,0,153,30
250173424002,1132,700,127,0,62,3,193,47,853,565,124,0,62,3,72,27,279,135,3,0,0,0,121,20
250173424003,905,572,116,6,101,0,94,16,714,480,108,2,99,0,16,9,191,92,8,4,2,0,78,7
250173424004,1348,754,127,5,89,2,298,73,942,580,116,4,89,0,101,52,406,174,11,1,0,2,197,21
250173424005,792,526,137,4,25,2,60,38,708,484,127,3,24,2,37,31,84,42,10,1,1,0,23,7
250173425001,2428,1469,311,9,117,0,424,98,1796,1177,307,4,117,0,135,56,632,292,4,5,0,0,289,42
250173425002,2169,1419,337,5,85,0,245,78,1690,1171,314,2,85,0,71,47,479,248,23,3,0,0,174,31
250173425003,2200,1277,318,6,135,0,374,90,1729,1116,294,1,130,0,135,53,471,161,24,5,5,0,239,37
250173426001,1125,616,165,12,52,0,220,60,781,499,155,3,52,0,47,25,344,117,10,9,0,0,173,35
250173426002,904,513,80,3,53,0,234,21,629,408,74,0,50,0,86,11,275,105,6,3,3,0,148,10
250173426003,2336,1406,324,1,151,4,389,61,1778,1174,322,1,151,4,87,39,558,232,2,0,0,0,302,22
250173501031,0,0,0,0,0,0,0,0,0,0,0,0,0,0,0,0,0,0,0,0,0,0,0,0
250173501032,1210,948,88,0,63,0,77,34,1099,905,85,0,63,0,27,19,111,43,3,0,0,0,50,15
250173501041,2119,1063,251,9,204,2,457,133,1647,908,236,4,204,1,191,103,472,155,15,5,0,1,266,30
250173501042,2584,1199,615,6,182,2,460,120,1896,956,592,1,179,0,84,84,688,243,23,5,3,2,376,36
250173501043,1188,766,120,5,85,2,184,26,888,653,105,1,85,0,26,18,300,113,15,4,0,2,158,8
250173501044,1384,954,127,10,115,0,133,45,1179,860,115,1,114,0,54,35,205,94,12,9,1,0,79,10
250173502001,1376,1065,125,0,64,1,48,73,1293,1017,123,0,63,1,25,64,83,48,2,0,1,0,23,9
250173502002,603,354,62,0,41,0,112,34,474,334,57,0,41,0,16,26,129,20,5,0,0,0,96,8
250173502003,1385,808,135,5,184,0,192,61,1115,684,131,0,184,0,70,46,270,124,4,5,0,0,122,15
250173502004,1410,998,112,3,140,3,85,69,1304,954,105,2,140,0,54,49,106,44,7,1,0,3,31,20
250173502005,749,439,87,4,46,0,135,38,569,386,82,0,46,0,29,26,180,53,5,4,0,0,106,12
250173502006,1044,778,61,1,74,0,84,46,930,742,50,1,74,0,29,34,114,36,11,0,0,0,55,12
250173503001,965,732,72,4,37,0,86,34,891,705,68,1,36,0,53,28,74,27,4,3,1,0,33,6
250173503002,627,455,48,2,99,0,9,14,608,442,48,2,99,0,4,13,19,13,0,0,0,0,5,1
250173503003,849,634,71,1,47,0,65,31,678,522,68,1,47,0,23,17,171,112,3,0,0,0,42,14
250173504001,1006,897,25,3,50,0,7,24,979,878,22,3,50,0,5,21,27,19,3,0,0,0,2,3
250173504002,1232,1070,36,2,80,0,14,30,1188,1037,36,2,79,0,10,24,44,33,0,0,1,0,4,6
250173504003,1017,876,33,1,68,0,7,32,984,854,32,1,67,0,3,27,33,22,1,0,1,0,4,5
250173504004,1464,1309,27,0,79,1,13,35,1413,1272,26,0,79,0,6,30,51,37,1,0,0,1,7,5
250173504005,849,756,10,1,55,0,7,20,823,737,9,1,55,0,2,19,26,19,1,0,0,0,5,1
250173505001,818,725,22,1,46,0,5,19,790,705,21,0,46,0,1,17,28,20,1,1,0,0,4,2
250173505002,811,732,13,1,40,2,2,21,795,720,12,1,40,1,0,21,16,12,1,0,0,1,2,0
250173506001,1656,1175,60,1,309,0,19,92,1562,1114,54,0,307,0,4,83,94,61,6,1,2,0,15,9
250173506002,939,804,23,1,86,0,13,12,902,782,22,1,84,0,3,10,37,22,1,0,2,0,10,2
250173506003,813,686,17,0,78,0,9,23,788,671,16,0,78,0,2,21,25,15,1,0,0,0,7,2
250173506004,1164,1038,13,4,75,0,8,26,1132,1017,12,2,75,0,3,23,32,21,1,2,0,0,5,3
250173507001,907,835,26,1,25,0,6,14,877,815,22,1,25,0,1,13,30,20,4,0,0,0,5,1
250173507002,974,493,215,1,60,0,158,47,720,418,195,1,60,0,20,26,254,75,20,0,0,0,138,21
250173507003,1007,907,30,0,36,1,16,17,957,873,28,0,36,0,5,15,50,34,2,0,0,1,11,2
250173507004,1375,790,379,2,85,0,33,86,1308,761,374,2,85,0,9,77,67,29,5,0,0,0,24,9
250173507005,861,745,16,0,69,0,14,17,825,725,13,0,69,0,4,14,36,20,3,0,0,0,10,3
250173507006,924,809,16,1,59,0,14,25,886,788,15,0,59,0,2,22,38,21,1,1,0,0,12,3
250173508001,971,778,89,0,69,0,7,28,942,758,89,0,69,0,1,25,29,20,0,0,0,0,6,3
250173508002,857,704,62,1,54,0,12,24,809,675,56,0,54,0,3,21,48,29,6,1,0,0,9,3
250173509001,803,708,7,2,59,0,7,20,771,689,5,1,58,0,1,17,32,19,2,1,1,0,6,3
250173509002,1209,1069,22,4,78,0,3,33,1168,1035,20,4,78,0,0,31,41,34,2,0,0,0,3,2
250173509003,1302,1121,37,0,98,1,9,36,1248,1087,30,0,98,1,2,30,54,34,7,0,0,0,7,6
250173510001,1236,1031,57,0,84,0,24,40,1166,992,51,0,84,0,10,29,70,39,6,0,0,0,14,11
250173510002,636,567,8,3,45,0,0,13,605,545,6,0,45,0,0,9,31,22,2,3,0,0,0,4
250173510003,691,514,24,2,129,2,7,13,658,491,24,1,128,2,0,12,33,23,0,1,1,0,7,1
250173510004,1813,1495,36,2,203,0,28,49,1724,1440,34,0,201,0,3,46,89,55,2,2,2,0,25,3
250173510005,1056,860,41,8,113,1,19,14,1010,825,41,7,113,1,11,12,46,35,0,1,0,0,8,2
250173510006,1018,864,14,0,107,0,20,13,978,842,13,0,107,0,4,12,40,22,1,0,0,0,16,1
250173511001,1601,1240,116,1,143,0,65,36,1478,1187,104,0,139,0,18,30,123,53,12,1,4,0,47,6
250173511002,912,750,48,4,75,0,13,22,870,728,45,4,75,0,2,16,42,22,3,0,0,0,11,6
250173511003,1241,1014,57,0,117,0,26,27,1169,969,54,0,117,0,9,20,72,45,3,0,0,0,17,7
250173511004,722,614,26,0,55,1,6,20,701,599,26,0,55,1,3,17,21,15,0,0,0,0,3,3
250173511005,1146,1018,38,0,50,2,18,20,1103,984,38,0,50,2,9,20,43,34,0,0,0,0,9,0
250173512031,974,806,26,1,100,0,15,26,930,777,24,1,100,0,6,22,44,29,2,0,0,0,9,4
250173512032,1101,840,55,1,130,1,21,53,1041,807,53,1,130,1,10,39,60,33,2,0,0,0,11,14
250173512033,1047,899,29,5,74,0,20,20,997,868,28,4,73,0,7,17,50,31,1,1,1,0,13,3
250173512034,1119,832,32,4,192,1,16,42,1061,787,32,3,192,1,7,39,58,45,0,1,0,0,9,3
250173512041,1233,893,93,2,131,2,74,38,1112,822,89,2,131,0,40,28,121,71,4,0,0,2,34,10
250173512042,1715,1137,116,6,218,0,164,74,1542,1073,116,1,218,0,80,54,173,64,0,5,0,0,84,20
250173512043,1181,927,47,2,154,1,8,42,1129,889,47,1,154,1,1,36,52,38,0,1,0,0,7,6
250173513001,1898,1414,115,2,163,1,118,85,1751,1346,108,2,162,1,53,79,147,68,7,0,1,0,65,6
250173513002,1441,1143,105,5,68,0,61,59,1366,1101,104,3,68,0,47,43,75,42,1,2,0,0,14,16
250173513003,894,691,34,16,59,1,49,44,803,642,30,2,59,0,31,39,91,49,4,14,0,1,18,5
250173514031,763,452,50,3,119,0,107,32,561,367,43,0,119,0,11,21,202,85,7,3,0,0,96,11
250173514032,1017,583,67,3,53,1,265,45,631,447,65,2,50,1,54,12,386,136,2,1,3,0,211,33
250173514033,587,377,66,7,43,0,80,14,483,348,65,4,43,0,15,8,104,29,1,3,0,0,65,6
250173514034,1042,516,94,13,66,0,303,50,712,425,84,1,66,0,101,35,330,91,10,12,0,0,202,15
250173514035,619,372,60,1,67,0,86,33,467,312,56,1,67,0,13,18,152,60,4,0,0,0,73,15
250173514041,1147,686,53,10,196,0,136,66,969,586,44,10,195,0,72,62,178,100,9,0,1,0,64,4
250173514042,1335,745,153,9,120,0,238,70,996,595,151,0,120,0,85,45,339,150,2,9,0,0,153,25
250173514043,1026,604,69,4,117,0,171,61,845,509,64,1,117,0,101,53,181,95,5,3,0,0,70,8
250173514044,781,399,68,0,109,2,170,33,543,315,58,0,109,1,42,18,238,84,10,0,0,1,128,15
250173515001,468,386,13,1,38,0,6,24,430,364,8,1,38,0,1,18,38,22,5,0,0,0,5,6
250173515002,1842,1105,199,6,229,0,206,97,1468,898,190,4,227,0,71,78,374,207,9,2,2,0,135,19
250173521011,181,106,11,1,52,0,3,8,163,92,11,1,52,0,0,7,18,14,0,0,0,0,3,1
250173521012,1473,967,96,0,321,0,42,47,1259,803,91,0,320,0,5,40,214,164,5,0,1,0,37,7
250173521021,1165,889,42,0,181,1,11,41,1114,857,38,0,179,1,4,35,51,32,4,0,2,0,7,6
250173521022,1112,856,51,3,141,1,37,23,1036,811,50,0,140,1,13,21,76,45,1,3,1,0,24,2
250173522001,1849,1251,190,7,259,0,83,59,1659,1160,159,6,259,0,30,45,190,91,31,1,0,0,53,14
250173523001,1884,1381,115,6,244,0,49,89,1687,1280,97,2,243,0,10,55,197,101,18,4,1,0,39,34
250173523002,1566,944,141,2,398,0,23,58,1417,822,135,2,398,0,6,54,149,122,6,0,0,0,17,4
250173524001,259,178,18,0,45,0,13,5,235,164,18,0,45,0,4,4,24,14,0,0,0,0,9,1
250173524002,1867,523,858,5,220,0,134,127,1541,403,821,0,219,0,14,84,326,120,37,5,1,0,120,43
250173525001,1400,794,337,1,134,4,47,83,1253,729,310,1,134,2,8,69,147,65,27,0,0,2,39,14
250173525002,1494,916,269,7,171,2,57,72,1357,858,258,6,169,2,3,61,137,58,11,1,2,0,54,11
250173526001,1274,869,139,0,128,0,80,58,1106,768,131,0,128,0,36,43,168,101,8,0,0,0,44,15
250173526002,1104,755,138,4,119,0,42,46,1007,720,119,2,119,0,10,37,97,35,19,2,0,0,32,9
250173527001,676,507,40,4,65,1,21,38,608,474,34,2,62,1,9,26,68,33,6,2,3,0,12,12
250173527002,1061,501,395,1,47,0,62,55,930,447,375,0,47,0,26,35,131,54,20,1,0,0,36,20
250173527003,320,250,18,0,26,0,16,10,291,241,13,0,26,0,2,9,29,9,5,0,0,0,14,1
250173528001,345,242,44,0,53,0,0,6,325,240,29,0,53,0,0,3,20,2,15,0,0,0,0,3
250173528002,1770,1266,186,5,113,0,112,88,1576,1190,165,5,113,0,38,65,194,76,21,0,0,0,74,23
250173529001,978,719,107,0,103,0,26,23,920,681,100,0,103,0,14,22,58,38,7,0,0,0,12,1
250173529002,1668,1422,38,3,148,0,20,37,1588,1356,35,2,148,0,11,36,80,66,3,1,0,0,9,1
250173530001,85,49,26,0,2,0,6,2,69,41,24,0,2,0,1,1,16,8,2,0,0,0,5,1
250173530002,625,390,124,0,61,1,14,35,565,355,117,0,60,1,3,29,60,35,7,0,1,0,11,6
250173530003,851,459,165,3,164,0,29,31,775,424,155,1,164,0,3,28,76,35,10,2,0,0,26,3
250173530004,2023,1438,113,2,331,2,48,89,1862,1339,110,2,331,2,8,70,161,99,3,0,0,0,40,19
250173531011,1379,885,124,6,250,0,32,82,1260,802,120,5,249,0,7,77,119,83,4,1,1,0,25,5
250173531012,1081,567,255,3,129,1,57,69,934,509,231,1,127,1,5,60,147,58,24,2,2,0,52,9
250173531021,2488,1102,175,8,1001,2,53,147,2203,905,168,8,998,0,7,117,285,197,7,0,3,2,46,30
250173531022,1409,833,42,4,436,0,20,74,1228,695,32,3,433,0,5,60,181,138,10,1,3,0,15,14
250173531023,1143,566,72,1,407,0,19,78,1048,501,69,1,405,0,2,70,95,65,3,0,2,0,17,8
250173532001,2900,1582,287,1,859,2,50,119,2672,1436,261,0,859,2,17,97,228,146,26,1,0,0,33,22
250173532002,1032,742,133,2,89,1,17,48,939,677,129,2,88,1,8,34,93,65,4,0,1,0,9,14
250173532003,965,741,69,4,108,0,18,25,925,713,68,3,108,0,11,22,40,28,1,1,0,0,7,3
250173533001,998,786,78,2,78,0,11,43,949,751,76,2,78,0,3,39,49,35,2,0,0,0,8,4
250173533002,1515,1110,197,3,102,3,41,59,1423,1059,186,3,101,3,17,54,92,51,11,0,1,0,24,5
250173533003,958,815,19,1,78,0,5,40,929,798,17,0,77,0,0,37,29,17,2,1,1,0,5,3
250173534001,1226,676,299,7,126,0,52,66,1103,628,283,4,126,0,5,57,123,48,16,3,0,0,47,9
250173534002,1622,760,526,11,196,1,29,99,1504,711,503,6,195,1,5,83,118,49,23,5,1,0,24,16
250173535001,1108,769,120,5,163,3,11,37,1046,735,115,4,162,3,1,26,62,34,5,1,1,0,10,11
250173535002,1494,866,405,2,119,0,30,72,1381,812,388,1,119,0,8,53,113,54,17,1,0,0,22,19
250173536001,522,423,17,0,53,1,8,20,491,397,17,0,53,1,6,17,31,26,0,0,0,0,2,3
250173536002,944,738,70,3,90,0,11,32,886,702,68,1,90,0,0,25,58,36,2,2,0,0,11,7
250173536003,668,561,35,0,38,0,9,25,642,543,35,0,38,0,4,22,26,18,0,0,0,0,5,3
250173536004,668,529,23,0,74,0,6,36,634,507,20,0,74,0,0,33,34,22,3,0,0,0,6,3
250173536005,1749,1222,97,5,336,0,14,75,1652,1153,90,5,335,0,1,68,97,69,7,0,1,0,13,7
250173537001,1039,881,49,2,69,0,19,19,994,858,47,2,69,0,2,16,45,23,2,0,0,0,17,3
250173537002,1141,865,41,1,191,0,13,30,1069,807,39,0,190,0,6,27,72,58,2,1,1,0,7,3
250173537003,1460,906,76,1,323,0,20,134,1358,835,75,0,322,0,6,120,102,71,1,1,1,0,14,14
250173537004,873,552,34,1,233,0,14,39,805,501,32,1,232,0,3,36,68,51,2,0,1,0,11,3
250173537005,852,541,42,3,191,0,17,58,785,502,38,2,190,0,5,48,67,39,4,1,1,0,12,10
250173538001,722,570,21,0,92,0,4,35,692,546,21,0,92,0,1,32,30,24,0,0,0,0,3,3
250173538002,1332,996,79,1,204,0,16,36,1258,931,79,1,203,0,11,33,74,65,0,0,1,0,5,3
250173538003,1829,1373,110,0,271,0,19,56,1718,1288,104,0,270,0,7,49,111,85,6,0,1,0,12,7
250173538004,819,570,37,0,190,0,9,13,777,534,36,0,189,0,5,13,42,36,1,0,1,0,4,0
250173539001,2212,1466,165,4,425,0,21,131,2068,1362,158,4,423,0,0,121,144,104,7,0,2,0,21,10
250173539002,2507,1213,170,7,974,0,39,104,2231,985,166,6,973,0,14,87,276,228,4,1,1,0,25,17
250173539003,2371,1510,188,0,495,2,28,148,2213,1396,185,0,495,2,2,133,158,114,3,0,0,0,26,15
250173540001,954,827,16,3,77,0,5,26,906,793,15,0,77,0,3,18,48,34,1,3,0,0,2,8
250173540002,2185,1637,96,7,346,0,17,82,2059,1545,92,7,344,0,2,69,126,92,4,0,2,0,15,13
250173540003,1227,918,42,3,212,0,14,38,1137,850,42,1,209,0,1,34,90,68,0,2,3,0,13,4
250173541001,371,320,6,0,26,0,3,16,358,310,6,0,26,0,1,15,13,10,0,0,0,0,2,1
250173541002,586,523,13,0,37,0,6,7,569,508,11,0,37,0,6,7,17,15,2,0,0,0,0,0
250173541003,1036,872,42,1,85,1,4,31,985,827,41,0,85,1,0,31,51,45,1,1,0,0,4,0
250173541004,914,722,43,1,110,0,10,28,848,672,43,1,108,0,3,21,66,50,0,0,2,0,7,7
250173542001,1219,1099,23,1,43,0,12,41,1182,1071,23,1,43,0,8,36,37,28,0,0,0,0,4,5
250173542002,999,893,23,2,47,0,4,30,961,863,21,1,47,0,3,26,38,30,2,1,0,0,1,4
250173542003,689,628,8,4,34,0,5,10,669,611,8,2,34,0,4,10,20,17,0,2,0,0,1,0
250173543001,1397,757,383,8,105,0,61,83,1245,703,361,5,105,0,6,65,152,54,22,3,0,0,55,18
250173543002,828,648,50,2,90,3,13,22,783,617,48,2,90,0,6,20,45,31,2,0,0,3,7,2
250173543003,1121,943,54,2,82,0,16,24,1072,913,49,2,82,0,8,18,49,30,5,0,0,0,8,6
250173544001,812,685,52,9,28,0,6,32,771,657,43,8,28,0,5,30,41,28,9,1,0,0,1,2
250173544002,835,697,40,2,56,0,7,33,809,677,38,2,56,0,4,32,26,20,2,0,0,0,3,1
250173545001,874,731,31,2,84,0,5,21,829,698,27,1,82,0,2,19,45,33,4,1,2,0,3,2
250173545002,880,744,28,0,81,0,7,20,840,710,27,0,81,0,2,20,40,34,1,0,0,0,5,0
250173545003,482,406,18,1,47,0,3,7,455,384,17,0,47,0,0,7,27,22,1,1,0,0,3,0
250173546001,2116,1047,695,3,259,0,23,89,2013,983,678,3,258,0,9,82,103,64,17,0,1,0,14,7
250173546002,737,589,67,2,43,0,6,30,703,562,62,1,43,0,6,29,34,27,5,1,0,0,0,1
250173546003,853,454,271,4,68,0,14,42,800,425,262,4,68,0,4,37,53,29,9,0,0,0,10,5
250173546004,832,612,65,1,120,0,18,16,788,587,64,1,120,0,4,12,44,25,1,0,0,0,14,4
250173547001,1258,1002,66,4,124,1,12,49,1199,965,64,0,124,1,2,43,59,37,2,4,0,0,10,6
250173547002,1251,1011,86,3,96,0,14,41,1204,977,86,2,95,0,5,39,47,34,0,1,1,0,9,2
250173548001,911,765,24,0,72,0,17,33,870,739,24,0,72,0,6,29,41,26,0,0,0,0,11,4
250173548002,992,833,60,2,64,0,5,28,957,811,59,0,62,0,1,24,35,22,1,2,2,0,4,4
250173549001,1126,853,103,2,98,0,14,56,1072,826,95,1,97,0,5,48,54,27,8,1,1,0,9,8
250173549002,3201,409,1603,15,835,5,174,160,2812,301,1529,11,831,5,26,109,389,108,74,4,4,0,148,51
250173549003,1731,1065,210,16,313,0,26,101,1611,1013,197,6,313,0,3,79,120,52,13,10,0,0,23,22
250173550001,671,507,40,2,98,0,5,19,632,479,40,0,95,0,0,18,39,28,0,2,3,0,5,1
250173550002,1183,859,175,0,76,0,12,61,1110,811,170,0,76,0,3,50,73,48,5,0,0,0,9,11
250173550003,835,562,104,0,107,0,16,46,779,537,96,0,106,0,5,35,56,25,8,0,1,0,11,11
250173561001,795,700,11,0,59,0,6,19,771,682,10,0,59,0,3,17,24,18,1,0,0,0,3,2
250173561002,1460,1271,14,4,99,1,11,60,1388,1218,14,2,98,1,2,53,72,53,0,2,1,0,9,7
250173561003,855,775,7,0,45,0,6,22,831,758,7,0,45,0,0,21,24,17,0,0,0,0,6,1
250173563001,1239,835,167,1,156,0,43,37,1112,774,149,1,156,0,8,24,127,61,18,0,0,0,35,13
250173563002,969,727,53,0,148,0,19,22,939,710,47,0,147,0,17,18,30,17,6,0,1,0,2,4
250173563003,721,636,17,0,49,4,0,15,705,620,17,0,49,4,0,15,16,16,0,0,0,0,0,0
250173563004,640,568,12,0,42,0,5,13,618,552,12,0,42,0,0,12,22,16,0,0,0,0,5,1
250173563005,776,652,17,1,66,0,11,29,756,639,17,1,66,0,4,29,20,13,0,0,0,0,7,0
250173563006,695,587,22,1,66,0,5,14,667,566,19,1,66,0,1,14,28,21,3,0,0,0,4,0
250173216004,1758,1212,35,2,297,0,131,81,1612,1143,31,2,297,0,73,66,146,69,4,0,0,0,58,15
250173221001,1198,1158,4,2,18,0,3,13,1174,1134,4,2,18,0,3,13,24,24,0,0,0,0,0,0
250173221002,1083,1017,7,0,40,0,13,6,1053,1002,7,0,40,0,0,4,30,15,0,0,0,0,13,2
250173221003,924,844,9,2,25,0,20,24,902,834,9,1,25,0,11,22,22,10,0,1,0,0,9,2
250173221004,1466,1382,11,1,33,0,29,10,1424,1365,11,0,32,0,6,10,42,17,0,1,1,0,23,0
250173222001,1304,1124,41,0,29,0,56,54,1237,1083,41,0,27,0,43,43,67,41,0,0,2,0,13,11
250173222002,2383,2229,24,1,53,0,33,43,2315,2187,22,1,53,0,12,40,68,42,2,0,0,0,21,3
250173223001,1870,1701,43,6,39,0,43,38,1747,1613,43,0,39,0,16,36,123,88,0,6,0,0,27,2
250173223002,2803,2465,56,10,106,0,96,70,2604,2338,55,4,106,0,50,51,199,127,1,6,0,0,46,19
250173223003,1417,1323,25,1,17,0,24,27,1363,1284,24,1,15,0,18,21,54,39,1,0,2,0,6,6
250173224001,1757,1617,21,0,44,0,36,39,1712,1593,20,0,44,0,26,29,45,24,1,0,0,0,10,10
250173224002,1406,1198,33,3,14,0,86,72,1302,1129,27,3,14,0,63,66,104,69,6,0,0,0,23,6
250173224003,1452,1416,15,1,13,0,3,4,1416,1383,13,1,13,0,2,4,36,33,2,0,0,0,1,0
250173231001,2043,1891,15,3,82,0,9,43,2014,1871,15,3,82,0,3,40,29,20,0,0,0,0,6,3
250173231002,872,831,1,1,28,0,3,8,862,822,1,0,28,0,3,8,10,9,0,1,0,0,0,0
250173231003,1113,1036,17,1,27,0,8,24,1090,1018,17,1,27,0,4,23,23,18,0,0,0,0,4,1
250173231004,2562,2411,11,6,81,0,5,48,2502,2368,11,5,76,0,0,42,60,43,0,1,5,0,5,6
250173241011,1972,1815,15,1,116,0,2,23,1949,1795,15,1,116,0,2,20,23,20,0,0,0,0,0,3
250173241012,1265,1194,5,1,40,0,2,23,1246,1178,5,0,40,0,1,22,19,16,0,1,0,0,1,1
250173241013,1524,1450,11,0,25,0,0,38,1505,1437,11,0,23,0,0,34,19,13,0,0,2,0,0,4
250173241021,947,890,5,3,37,0,4,8,930,884,1,0,37,0,0,8,17,6,4,3,0,0,4,0
250173241022,2488,2318,15,5,101,0,2,47,2461,2298,11,5,101,0,2,44,27,20,4,0,0,0,0,3
250173241023,728,661,3,0,33,0,8,23,712,647,3,0,33,0,7,22,16,14,0,0,0,0,1,1
250173251001,1473,1268,56,1,68,1,34,45,1410,1241,56,1,64,1,8,39,63,27,0,0,4,0,26,6
250173251002,1401,1226,54,0,48,3,23,47,1357,1210,54,0,48,1,3,41,44,16,0,0,0,2,20,6
250173251003,922,772,61,4,44,4,14,23,876,745,56,2,44,4,3,22,46,27,5,2,0,0,11,1
250173251004,802,700,32,7,12,0,13,38,747,677,30,6,12,0,1,21,55,23,2,1,0,0,12,17
250173251005,936,750,130,1,14,1,15,25,859,701,127,0,14,1,1,15,77,49,3,1,0,0,14,10
250173251006,1302,1018,92,4,73,3,57,55,1208,970,88,4,73,3,18,52,94,48,4,0,0,0,39,3
250173251007,591,526,14,2,11,4,18,16,549,501,14,2,11,1,7,13,42,25,0,0,0,3,11,3
250173261011,956,906,8,0,20,0,5,17,937,892,8,0,20,0,0,17,19,14,0,0,0,0,5,0
250173261012,2940,2777,13,2,86,1,13,48,2890,2744,13,2,86,1,4,40,50,33,0,0,0,0,9,8
250173261021,2478,2348,15,0,69,0,7,39,2442,2326,14,0,68,0,0,34,36,22,1,0,1,0,7,5
250173261022,2674,2535,7,5,84,0,11,32,2612,2481,7,5,84,0,4,31,62,54,0,0,0,0,7,1
250173261023,1598,1545,3,0,35,0,0,15,1572,1521,3,0,35,0,0,13,26,24,0,0,0,0,0,2
250173271011,1800,1733,9,8,21,0,6,23,1776,1718,9,5,20,0,2,22,24,15,0,3,1,0,4,1
250173271012,1786,1742,4,0,15,0,1,24,1762,1722,4,0,15,0,0,21,24,20,0,0,0,0,1,3
250173271021,1087,1027,17,4,13,0,1,25,1056,1005,15,4,13,0,0,19,31,22,2,0,0,0,1,6
250173271022,1522,1485,4,1,18,0,4,10,1506,1471,4,0,18,0,4,9,16,14,0,1,0,0,0,1
250173271023,1724,1620,25,3,33,1,17,25,1682,1597,17,3,33,0,9,23,42,23,8,0,0,1,8,2
250173271031,1589,1542,0,0,13,0,6,28,1558,1522,0,0,13,0,0,23,31,20,0,0,0,0,6,5
250173271032,780,760,1,1,5,0,2,11,771,751,1,1,5,0,2,11,9,9,0,0,0,0,0,0
250173271033,1209,1173,0,3,16,1,4,12,1192,1160,0,1,16,0,3,12,17,13,0,2,0,1,1,0
250173281001,1992,1891,3,1,74,4,0,19,1960,1860,3,1,73,4,0,19,32,31,0,0,1,0,0,0
250173281002,1187,1140,4,2,24,0,0,17,1175,1133,3,2,24,0,0,13,12,7,1,0,0,0,0,4
250173301001,1045,1011,3,0,20,0,1,10,1025,995,3,0,20,0,0,7,20,16,0,0,0,0,1,3
250173301002,2140,2051,10,3,49,0,11,16,2106,2024,10,3,49,0,5,15,34,27,0,0,0,0,6,1
250173301003,1437,1385,4,6,25,0,0,17,1412,1367,4,0,25,0,0,16,25,18,0,6,0,0,0,1
250173301004,1567,1504,4,0,41,0,3,15,1538,1478,4,0,41,0,0,15,29,26,0,0,0,0,3,0
250173301005,2042,1989,5,1,33,0,2,12,2029,1977,5,1,33,0,2,11,13,12,0,0,0,0,0,1
250173302001,2628,2493,15,3,66,0,16,35,2584,2460,15,2,66,0,7,34,44,33,0,1,0,0,9,1
250173302002,1789,1676,13,2,57,0,10,31,1769,1660,13,2,57,0,6,31,20,16,0,0,0,0,4,0
250173302003,1068,1000,15,4,37,0,6,6,1056,992,15,4,37,0,3,5,12,8,0,0,0,0,3,1
250173302004,1176,1065,15,4,69,0,4,19,1142,1038,15,4,69,0,1,15,34,27,0,0,0,0,3,4
250173311011,1309,1235,4,0,45,0,5,20,1289,1222,4,0,45,0,0,18,20,13,0,0,0,0,5,2
250173311012,1702,1507,32,2,116,8,11,26,1665,1482,31,2,116,8,1,25,37,25,1,0,0,0,10,1
250173311021,1296,1239,5,1,31,0,3,17,1278,1228,4,1,31,0,0,14,18,11,1,0,0,0,3,3
250173311022,1949,1836,17,1,44,0,12,39,1903,1813,17,1,44,0,2,26,46,23,0,0,0,0,10,13
250173311023,2267,2166,16,6,52,0,5,22,2229,2140,10,6,52,0,2,19,38,26,6,0,0,0,3,3
250173311024,1459,1359,11,1,77,0,0,11,1432,1335,9,1,77,0,0,10,27,24,2,0,0,0,0,1
250173312001,2367,2234,20,2,86,0,10,15,2337,2211,18,1,86,0,6,15,30,23,2,1,0,0,4,0
250173312002,2979,2755,25,0,118,5,24,52,2934,2728,25,0,118,4,11,48,45,27,0,0,0,1,13,4
250173313001,2385,2179,13,3,121,0,16,53,2328,2141,13,2,121,0,4,47,57,38,0,1,0,0,12,6
250173313002,2541,2404,17,1,78,0,13,28,2494,2372,17,1,78,0,3,23,47,32,0,0,0,0,10,5
250173313003,2071,1955,14,1,63,0,18,20,2033,1928,14,0,63,0,10,18,38,27,0,1,0,0,8,2
250173321001,1276,1096,18,0,141,0,0,21,1256,1076,18,0,141,0,0,21,20,20,0,0,0,0,0,0
250173321002,2269,1973,27,3,237,0,4,25,2259,1967,27,3,237,0,1,24,10,6,0,0,0,0,3,1
250173321003,1223,1065,19,0,111,0,7,21,1199,1047,19,0,111,0,1,21,24,18,0,0,0,0,6,0
250173321004,1204,999,15,1,161,0,3,25,1175,976,15,0,161,0,1,22,29,23,0,1,0,0,2,3
250173322001,3034,1857,305,12,707,1,83,69,2886,1778,300,10,705,1,35,57,148,79,5,2,2,0,48,12
250173322002,2576,2147,33,8,333,0,8,47,2513,2096,33,6,333,0,2,43,63,51,0,2,0,0,6,4
250173322003,676,616,9,0,43,0,0,8,665,607,9,0,43,0,0,6,11,9,0,0,0,0,0,2
250173322004,2090,1763,29,2,232,5,27,32,2017,1713,29,2,229,4,9,31,73,50,0,0,3,1,18,1
250173323001,1222,1052,26,1,127,0,4,12,1202,1032,26,1,127,0,4,12,20,20,0,0,0,0,0,0
250173323002,992,857,6,1,115,0,0,13,988,854,6,1,115,0,0,12,4,3,0,0,0,0,0,1
250173323003,1054,965,8,1,75,0,2,3,1041,954,8,1,75,0,0,3,13,11,0,0,0,0,2,0
250173323004,2054,1221,211,3,531,0,44,44,1994,1189,210,3,531,0,19,42,60,32,1,0,0,0,25,2
250173323005,1355,1228,8,1,108,0,0,10,1347,1221,8,1,108,0,0,9,8,7,0,0,0,0,0,1
250173324001,1959,1723,32,5,170,0,6,23,1913,1688,27,4,170,0,6,18,46,35,5,1,0,0,0,5
250173324002,1514,1223,55,1,180,0,16,39,1465,1194,52,0,180,0,5,34,49,29,3,1,0,0,11,5
250173331001,2266,1724,186,1,284,0,38,33,2183,1667,185,0,284,0,18,29,83,57,1,1,0,0,20,4
250173331002,1015,926,7,1,75,0,0,6,1008,919,7,1,75,0,0,6,7,7,0,0,0,0,0,0
250173331003,1146,992,53,0,80,0,11,10,1118,980,50,0,80,0,3,5,28,12,3,0,0,0,8,5
250173331004,909,860,5,0,20,0,16,8,883,841,5,0,19,0,11,7,26,19,0,0,1,0,5,1
250173331005,2063,1921,13,3,87,0,17,22,2030,1899,13,3,87,0,6,22,33,22,0,0,0,0,11,0
250173332001,1514,1410,32,2,46,0,13,11,1480,1382,32,2,46,0,7,11,34,28,0,0,0,0,6,0
250173332002,1001,910,25,4,46,0,7,9,980,894,23,4,46,0,5,8,21,16,2,0,0,0,2,1
250173332003,1172,1021,42,0,42,0,30,37,1116,996,42,0,42,0,7,29,56,25,0,0,0,0,23,8
250173332004,1677,1437,85,2,120,1,15,17,1626,1413,81,1,120,1,2,8,51,24,4,1,0,0,13,9
250173333001,1153,908,76,3,68,0,74,24,1048,867,75,3,67,0,17,19,105,41,1,0,1,0,57,5
250173333002,1374,1146,83,2,54,0,53,36,1262,1075,81,2,54,0,25,25,112,71,2,0,0,0,28,11
250173333003,1536,1356,62,3,33,0,41,41,1454,1318,60,2,33,0,14,27,82,38,2,1,0,0,27,14
250173334001,1716,1214,99,4,253,0,80,66,1607,1160,96,4,253,0,46,48,109,54,3,0,0,0,34,18
250173334002,1230,1114,28,1,51,0,13,23,1204,1095,28,1,51,0,8,21,26,19,0,0,0,0,5,2
250173334003,868,808,21,0,27,0,5,7,832,776,20,0,27,0,2,7,36,32,1,0,0,0,3,0
250173334004,1387,1088,118,3,89,0,56,33,1242,1018,111,0,88,0,9,16,145,70,7,3,1,0,47,17
250173334005,1028,944,26,0,25,0,10,23,992,928,24,0,25,0,0,15,36,16,2,0,0,0,10,8
250173335011,744,644,25,0,40,0,30,5,707,623,20,0,40,0,19,5,37,21,5,0,0,0,11,0
250173335012,2171,1981,53,9,74,0,28,26,2102,1945,53,4,74,0,8,18,69,36,0,5,0,0,20,8
250173335013,2086,1848,92,3,77,0,34,32,1981,1773,92,3,77,0,4,32,105,75,0,0,0,0,30,0
250173335021,1633,1309,67,2,97,0,84,74,1492,1237,62,2,96,0,34,61,141,72,5,0,1,0,50,13
250173335022,1640,1417,62,2,58,1,55,45,1538,1370,58,2,58,1,14,35,102,47,4,0,0,0,41,10
250173336001,1976,975,169,11,702,0,50,69,1901,939,160,8,702,0,32,60,75,36,9,3,0,0,18,9
250173336002,861,792,2,0,53,0,7,7,836,771,0,0,53,0,5,7,25,21,2,0,0,0,2,0
250173336003,615,556,4,0,38,0,9,8,599,547,4,0,38,0,2,8,16,9,0,0,0,0,7,0
250173336004,1010,864,44,1,61,0,18,22,983,851,43,0,60,0,13,16,27,13,1,1,1,0,5,6
250173336005,985,888,36,0,33,0,13,15,937,855,35,0,33,0,3,11,48,33,1,0,0,0,10,4
250173336006,1344,1054,77,4,142,0,29,38,1255,991,77,4,142,0,11,30,89,63,0,0,0,0,18,8
250173341001,1723,1619,13,3,67,0,6,15,1698,1601,13,0,67,0,2,15,25,18,0,3,0,0,4,0
250173341002,2069,2007,4,2,31,3,1,21,2048,1989,4,0,31,3,0,21,21,18,0,2,0,0,1,0
250173341003,2926,2561,78,4,212,0,30,41,2846,2514,73,4,211,0,11,33,80,47,5,0,1,0,19,8
250173342001,981,947,4,1,22,0,4,3,972,941,4,0,22,0,2,3,9,6,0,1,0,0,2,0
250173342002,905,847,3,2,24,0,7,22,879,836,3,0,24,0,0,16,26,11,0,2,0,0,7,6
250173342003,976,914,9,0,42,0,6,5,962,904,9,0,42,0,2,5,14,10,0,0,0,0,4,0
250173342004,1106,1062,3,1,20,0,1,19,1085,1045,3,1,20,0,1,15,21,17,0,0,0,0,0,4
250173343001,1847,1796,9,0,24,0,7,11,1827,1782,9,0,24,0,2,10,20,14,0,0,0,0,5,1
250173343002,1058,1024,1,0,31,0,0,2,1043,1009,1,0,31,0,0,2,15,15,0,0,0,0,0,0
250173343003,1935,1810,14,0,79,0,6,26,1909,1796,14,0,78,0,0,21,26,14,0,0,1,0,6,5
250173343004,2765,2660,3,1,79,0,3,19,2736,2633,3,1,79,0,1,19,29,27,0,0,0,0,2,0
250173344001,1232,1168,4,0,43,0,1,16,1225,1163,4,0,43,0,0,15,7,5,0,0,0,0,1,1
250173344002,1769,1646,9,3,87,3,1,20,1742,1627,9,3,87,3,0,13,27,19,0,0,0,0,1,7
250173344003,1456,1226,14,0,187,0,9,20,1423,1199,14,0,187,0,4,19,33,27,0,0,0,0,5,1
250173344004,598,559,1,0,15,0,4,19,588,553,1,0,15,0,1,18,10,6,0,0,0,0,3,1
250173344005,1401,1295,19,1,68,0,5,13,1386,1285,19,1,68,0,0,13,15,10,0,0,0,0,5,0
250173351001,1222,1195,5,0,14,0,4,4,1212,1188,4,0,14,0,2,4,10,7,1,0,0,0,2,0
250173351002,977,934,4,0,26,0,3,10,964,925,2,0,26,0,1,10,13,9,2,0,0,0,2,0
250173351003,545,494,17,4,20,0,3,7,522,475,17,4,20,0,0,6,23,19,0,0,0,0,3,1
250173351004,1229,1142,19,5,21,0,21,21,1170,1112,16,3,21,0,0,18,59,30,3,2,0,0,21,3
250173351005,982,957,4,0,10,0,3,8,979,955,4,0,10,0,2,8,3,2,0,0,0,0,1,0
250173351006,773,755,6,0,8,0,3,1,757,742,6,0,8,0,0,1,16,13,0,0,0,0,3,0
250173352001,850,833,4,1,5,0,4,3,842,828,2,0,5,0,4,3,8,5,2,1,0,0,0,0
250173352002,804,777,11,0,7,0,0,9,790,763,11,0,7,0,0,9,14,14,0,0,0,0,0,0
250173352003,780,760,7,1,6,0,1,5,764,745,7,1,6,0,0,5,16,15,0,0,0,0,1,0
250173352004,1532,1389,27,0,84,0,16,16,1478,1354,27,0,84,0,0,13,54,35,0,0,0,0,16,3
250173352005,1671,1601,7,0,47,0,2,14,1652,1582,7,0,47,0,2,14,19,19,0,0,0,0,0,0
250173353011,1969,1826,28,1,69,0,8,37,1935,1799,27,1,69,0,3,36,34,27,1,0,0,0,5,1
250173353012,1114,1019,11,3,51,0,7,23,1077,1000,9,0,50,0,1,17,37,19,2,3,1,0,6,6
250173353013,769,703,14,5,15,0,21,11,726,684,14,5,15,0,1,7,43,19,0,0,0,0,20,4
250173353021,735,643,7,1,44,0,17,23,698,628,7,0,44,0,2,17,37,15,0,1,0,0,15,6
250173353022,3040,2884,10,4,86,0,8,48,2982,2835,9,4,86,0,3,45,58,49,1,0,0,0,5,3
250173353023,846,810,2,0,26,0,5,3,828,795,2,0,26,0,3,2,18,15,0,0,0,0,2,1
250173354001,865,826,14,1,12,0,8,4,844,816,11,1,12,0,0,4,21,10,3,0,0,0,8,0
250173354002,1922,1824,21,1,49,0,1,26,1888,1792,21,1,49,0,0,25,34,32,0,0,0,0,1,1
250173354003,1393,1322,8,1,39,0,14,9,1368,1310,8,1,39,0,2,8,25,12,0,0,0,0,12,1
250173354004,914,879,3,2,21,0,1,8,881,853,3,1,21,0,0,3,33,26,0,1,0,0,1,5
250173361001,965,901,13,1,30,0,3,17,940,877,13,1,30,0,2,17,25,24,0,0,0,0,1,0
250173361002,1285,1190,23,0,50,0,5,17,1243,1152,23,0,50,0,3,15,42,38,0,0,0,0,2,2
250173361003,872,806,9,2,34,0,6,15,857,798,8,1,34,0,2,14,15,8,1,1,0,0,4,1
250173361004,802,755,8,0,20,0,1,18,791,744,8,0,20,0,1,18,11,11,0,0,0,0,0,0
250173361005,694,662,6,0,15,0,2,9,682,654,6,0,14,0,1,7,12,8,0,0,1,0,1,2
250173361006,742,668,28,1,24,1,8,12,721,653,28,1,24,1,3,11,21,15,0,0,0,0,5,1
250173362001,817,778,6,0,20,0,5,8,807,774,5,0,20,0,0,8,10,4,1,0,0,0,5,0
250173362002,924,879,3,2,33,0,0,7,918,874,3,1,33,0,0,7,6,5,0,1,0,0,0,0
250173362003,1025,1000,3,0,15,0,2,5,1009,987,3,0,15,0,0,4,16,13,0,0,0,0,2,1
250173362004,942,895,6,1,25,0,1,14,928,883,5,1,25,0,1,13,14,12,1,0,0,0,0,1
250173362005,599,549,13,1,24,0,9,3,581,538,13,1,24,0,4,1,18,11,0,0,0,0,5,2
250173362006,765,725,6,0,16,0,0,18,747,708,6,0,16,0,0,17,18,17,0,0,0,0,0,1
250173362007,1070,994,19,0,36,1,1,19,1047,979,19,0,36,0,1,12,23,15,0,0,0,1,0,7
250173363001,744,702,6,0,28,0,2,6,735,694,6,0,28,0,1,6,9,8,0,0,0,0,1,0
250173363002,677,646,3,0,12,0,2,14,665,638,3,0,12,0,0,12,12,8,0,0,0,0,2,2
250173363003,903,876,8,0,13,0,0,6,887,860,8,0,13,0,0,6,16,16,0,0,0,0,0,0
250173363004,720,694,4,2,11,0,3,6,710,689,4,1,11,0,0,5,10,5,0,1,0,0,3,1
250173363005,1398,1308,7,4,37,1,12,29,1347,1276,7,0,37,0,0,27,51,32,0,4,0,1,12,2
250173363006,1187,1098,27,2,43,0,2,15,1165,1081,25,1,43,0,0,15,22,17,2,1,0,0,2,0
250173363007,1035,932,38,1,27,0,14,23,1012,920,38,1,27,0,4,22,23,12,0,0,0,0,10,1
250173364011,937,765,82,0,39,0,23,28,891,745,78,0,39,0,4,25,46,20,4,0,0,0,19,3
250173364012,1933,1595,91,1,181,0,27,38,1868,1563,82,1,180,0,9,33,65,32,9,0,1,0,18,5
250173364013,1390,1093,83,0,140,0,38,36,1345,1065,78,0,140,0,32,30,45,28,5,0,0,0,6,6
250173364021,813,680,66,0,30,2,18,17,769,654,65,0,30,0,3,17,44,26,1,0,0,2,15,0
250173364022,1272,1165,30,0,53,0,4,20,1245,1149,27,0,53,0,0,16,27,16,3,0,0,0,4,4
250173364023,1275,1153,39,3,44,0,10,26,1249,1141,38,0,44,0,2,24,26,12,1,3,0,0,8,2
250173364024,1197,1085,29,1,22,0,37,23,1161,1065,26,1,22,0,27,20,36,20,3,0,0,0,10,3
250173371011,1387,1314,17,2,39,0,2,13,1365,1301,11,0,39,0,1,13,22,13,6,2,0,0,1,0
250173371012,1708,1554,41,8,42,0,28,35,1652,1526,39,8,42,0,5,32,56,28,2,0,0,0,23,3
250173371021,560,488,7,2,48,0,1,14,555,484,7,2,48,0,0,14,5,4,0,0,0,0,1,0
250173371022,2002,1859,27,4,71,0,17,24,1964,1835,27,2,71,0,8,21,38,24,0,2,0,0,9,3
250173371023,2480,2325,19,0,94,0,8,34,2428,2293,16,0,94,0,1,24,52,32,3,0,0,0,7,10
250173372011,1802,1672,39,0,70,0,10,11,1760,1641,37,0,70,0,2,10,42,31,2,0,0,0,8,1
250173372012,701,674,9,0,8,0,7,3,692,670,9,0,8,0,2,3,9,4,0,0,0,0,5,0
250173372013,689,607,9,2,25,0,33,13,660,587,7,2,25,0,27,12,29,20,2,0,0,0,6,1
250173372021,1220,1152,12,0,42,0,8,6,1201,1142,11,0,40,0,3,5,19,10,1,0,2,0,5,1
250173372022,1604,1525,16,0,33,0,9,21,1569,1502,16,0,33,0,0,18,35,23,0,0,0,0,9,3
250173372023,1086,988,15,2,27,1,35,18,1013,953,13,0,27,1,8,11,73,35,2,2,0,0,27,7
250173372024,939,869,9,0,54,0,1,6,928,862,9,0,54,0,0,3,11,7,0,0,0,0,1,3
250173373001,851,750,37,5,20,0,30,9,789,720,32,3,20,0,7,7,62,30,5,2,0,0,23,2
250173373002,710,633,17,0,22,0,13,25,644,594,7,0,22,0,4,17,66,39,10,0,0,0,9,8
250173373003,1254,1146,22,0,51,1,16,18,1202,1121,17,0,49,1,6,8,52,25,5,0,2,0,10,10
250173373004,1852,1661,76,0,72,2,18,23,1805,1629,74,0,72,2,5,23,47,32,2,0,0,0,13,0
250173373005,592,550,7,1,9,1,9,15,576,544,7,1,9,1,4,10,16,6,0,0,0,0,5,5
250173381001,1430,1174,15,5,184,0,6,46,1389,1146,15,1,183,0,0,44,41,28,0,4,1,0,6,2
250173381002,1534,1265,21,0,193,0,4,51,1503,1239,18,0,193,0,4,49,31,26,3,0,0,0,0,2
250173382001,2938,2141,76,2,604,1,28,86,2866,2096,75,2,602,1,13,77,72,45,1,0,2,0,15,9
250173382002,931,760,25,0,110,0,2,34,903,741,22,0,110,0,0,30,28,19,3,0,0,0,2,4
250173383001,707,664,2,0,33,0,0,8,695,652,2,0,33,0,0,8,12,12,0,0,0,0,0,0
250173383002,1229,1143,27,0,45,1,4,9,1199,1119,26,0,45,0,2,7,30,24,1,0,0,1,2,2
250173383003,1244,1170,0,3,45,0,1,25,1230,1156,0,3,45,0,1,25,14,14,0,0,0,0,0,0
250173384001,1656,1464,3,0,159,0,9,21,1622,1436,3,0,158,0,4,21,34,28,0,0,1,0,5,0
250173384002,1220,1174,1,0,34,2,5,4,1204,1162,1,0,34,2,3,2,16,12,0,0,0,0,2,2
250173384003,1409,1281,14,1,92,0,1,20,1393,1266,14,1,92,0,1,19,16,15,0,0,0,0,0,1
250173384004,1460,1226,2,2,186,0,8,36,1440,1211,2,2,186,0,3,36,20,15,0,0,0,0,5,0
250173385001,1433,1307,10,0,84,1,7,24,1407,1283,10,0,84,1,5,24,26,24,0,0,0,0,2,0
250173385002,1439,1343,3,0,76,0,0,17,1418,1322,3,0,76,0,0,17,21,21,0,0,0,0,0,0
250173385003,1394,1334,2,0,39,4,3,12,1370,1315,2,0,38,4,2,9,24,19,0,0,1,0,1,3
250173385004,1350,1179,20,4,114,0,2,31,1330,1165,20,3,113,0,2,27,20,14,0,1,1,0,0,4
250173391001,617,578,6,0,19,0,5,9,608,570,6,0,19,0,4,9,9,8,0,0,0,0,1,0
250173391002,1460,1310,69,7,27,0,26,21,1410,1266,69,7,27,0,22,19,50,44,0,0,0,0,4,2
250173391003,1169,955,64,16,77,0,18,39,1129,939,64,6,77,0,7,36,40,16,0,10,0,0,11,3
250173391004,1797,1594,83,2,79,0,19,20,1755,1569,81,0,79,0,11,15,42,25,2,2,0,0,8,5
250173391005,1399,1314,22,0,45,0,1,17,1378,1297,22,0,44,0,1,14,21,17,0,0,1,0,0,3
250173392001,757,725,17,0,10,0,2,3,741,711,17,0,10,0,0,3,16,14,0,0,0,0,2,0
250173392002,832,768,30,0,15,0,7,12,826,763,30,0,15,0,6,12,6,5,0,0,0,0,1,0
250173392003,989,908,25,2,23,0,7,24,949,880,25,2,23,0,3,16,40,28,0,0,0,0,4,8
250173392004,1449,1341,18,0,70,0,6,14,1430,1327,18,0,70,0,3,12,19,14,0,0,0,0,3,2
250173392005,909,840,15,1,26,0,2,25,893,830,11,0,26,0,1,25,16,10,4,1,0,0,1,0
250173392006,894,824,15,0,24,1,8,22,872,813,14,0,24,1,2,18,22,11,1,0,0,0,6,4
250173393001,679,494,117,6,16,0,17,29,648,480,116,1,16,0,9,26,31,14,1,5,0,0,8,3
250173393002,914,446,340,2,55,0,14,57,886,432,334,2,55,0,11,52,28,14,6,0,0,0,3,5
250173393003,1297,697,442,3,43,1,33,78,1222,668,434,2,43,0,15,60,75,29,8,1,0,1,18,18
250173394001,1033,832,111,5,41,0,20,24,1004,806,110,5,41,0,18,24,29,26,1,0,0,0,2,0
250173661001,789,650,5,0,130,0,0,4,769,630,5,0,130,0,0,4,20,20,0,0,0,0,0,0
250173661002,1084,888,9,1,160,1,6,19,1051,860,9,1,160,1,4,16,33,28,0,0,0,0,2,3
250173661003,812,694,21,0,79,0,7,11,789,681,16,0,79,0,4,9,23,13,5,0,0,0,3,2
250173661004,971,793,22,0,134,1,5,16,957,779,22,0,134,1,5,16,14,14,0,0,0,0,0,0
250173661005,1041,914,9,2,90,0,5,21,995,880,9,2,90,0,0,14,46,34,0,0,0,0,5,7
250173662011,2631,2359,18,1,201,0,6,46,2570,2312,13,1,200,0,3,41,61,47,5,0,1,0,3,5
250173662012,967,899,8,0,43,0,3,14,947,881,7,0,43,0,2,14,20,18,1,0,0,0,1,0
250173662021,1946,1749,8,0,155,0,10,24,1891,1708,7,0,154,0,1,21,55,41,1,0,1,0,9,3
250173662022,1940,1700,4,0,197,0,6,33,1914,1679,4,0,197,0,2,32,26,21,0,0,0,0,4,1
250173662023,813,684,9,0,97,0,3,20,796,672,9,0,97,0,0,18,17,12,0,0,0,0,3,2
250173671001,927,732,5,0,159,0,6,25,905,715,5,0,159,0,2,24,22,17,0,0,0,0,4,1
250173671002,1186,1065,3,0,104,0,3,11,1167,1047,3,0,104,0,2,11,19,18,0,0,0,0,1,0
250173671003,782,651,7,3,99,0,1,21,748,618,7,3,99,0,0,21,34,33,0,0,0,0,1,0
250173671004,1064,974,6,0,74,0,0,10,1049,962,5,0,74,0,0,8,15,12,1,0,0,0,0,2
250173672001,827,712,6,0,94,0,3,12,811,696,6,0,94,0,3,12,16,16,0,0,0,0,0,0
250173672002,1155,1047,11,0,72,0,4,21,1144,1037,11,0,72,0,4,20,11,10,0,0,0,0,0,1
250173672003,1732,1389,150,2,125,0,32,34,1644,1346,133,1,125,0,10,29,88,43,17,1,0,0,22,5
250173672004,812,679,5,0,106,0,2,20,802,673,5,0,106,0,1,17,10,6,0,0,0,0,1,3
250173672005,792,680,7,0,85,0,0,20,776,665,7,0,85,0,0,19,16,15,0,0,0,0,0,1
250173672006,1145,947,20,0,140,0,11,27,1115,923,19,0,140,0,7,26,30,24,1,0,0,0,4,1
250173672007,839,735,10,3,56,0,8,27,806,711,8,1,56,0,5,25,33,24,2,2,0,0,3,2
250173681011,989,909,10,4,41,0,0,25,954,882,10,3,41,0,0,18,35,27,0,1,0,0,0,7
250173681012,2707,1752,204,1,616,0,69,65,2524,1644,199,1,613,0,17,50,183,108,5,0,3,0,52,15
250173681013,1381,1074,64,6,184,0,25,28,1307,1019,60,6,184,0,14,24,74,55,4,0,0,0,11,4
250173681014,1024,916,15,0,76,0,7,10,1010,907,15,0,76,0,4,8,14,9,0,0,0,0,3,2
250173681021,2335,1665,220,6,303,0,80,61,2144,1564,217,0,303,0,6,54,191,101,3,6,0,0,74,7
250173681022,1292,1025,84,0,128,0,38,17,1227,996,83,0,128,0,4,16,65,29,1,0,0,0,34,1
250173682001,1357,1197,23,1,90,0,16,30,1315,1175,23,0,90,0,3,24,42,22,0,1,0,0,13,6
250173682002,698,583,27,1,47,0,20,20,654,567,23,1,47,0,0,16,44,16,4,0,0,0,20,4
250173682003,663,567,11,0,23,0,46,16,577,531,9,0,22,0,4,11,86,36,2,0,1,0,42,5
250173682004,1576,1100,178,6,166,0,78,48,1384,1014,164,4,166,0,2,34,192,86,14,2,0,0,76,14
250173683001,1136,761,112,2,96,4,128,33,935,697,111,0,96,1,12,18,201,64,1,2,0,3,116,15
250173683002,1003,686,73,3,69,0,123,49,751,577,71,0,68,0,11,24,252,109,2,3,1,0,112,25
250173683003,867,622,51,3,99,2,69,21,702,536,47,2,97,0,11,9,165,86,4,1,2,2,58,12
250173683004,1111,860,102,2,81,0,51,15,964,778,95,2,79,0,4,6,147,82,7,0,2,0,47,9
250173683005,1228,823,95,5,109,3,155,38,784,560,94,3,109,0,6,12,444,263,1,2,0,3,149,26
250173684001,1140,719,107,3,107,0,144,60,808,541,100,3,107,0,16,41,332,178,7,0,0,0,128,19
250173684002,3729,2702,180,6,673,3,53,112,3485,2544,163,6,667,2,12,91,244,158,17,0,6,1,41,21
250173684003,1304,879,87,0,279,0,24,35,1249,848,86,0,279,0,2,34,55,31,1,0,0,0,22,1
250173684004,1284,1190,23,0,50,0,11,10,1219,1137,23,0,50,0,0,9,65,53,0,0,0,0,11,1
250173684005,660,518,38,0,59,0,33,12,591,487,38,0,59,0,0,7,69,31,0,0,0,0,33,5
250173685001,988,597,53,3,103,0,192,40,684,508,50,2,103,0,5,16,304,89,3,1,0,0,187,24
250173685002,1016,683,51,9,105,10,124,34,749,567,46,2,105,5,8,16,267,116,5,7,0,5,116,18
250173685003,1293,868,52,2,177,11,158,25,1008,752,48,2,177,4,8,17,285,116,4,0,0,7,150,8
250173686001,689,585,21,0,18,0,55,10,603,560,19,0,18,0,1,5,86,25,2,0,0,0,54,5
250173686002,761,561,36,5,20,8,109,22,552,488,31,0,20,3,4,6,209,73,5,5,0,5,105,16
250173686003,1082,715,63,1,40,4,214,45,664,548,49,0,40,1,6,20,418,167,14,1,0,3,208,25
250173686004,1454,1064,75,3,73,1,210,28,1079,904,69,3,73,1,8,21,375,160,6,0,0,0,202,7
250173686005,1210,925,68,3,76,1,90,47,958,800,63,2,73,1,0,19,252,125,5,1,3,0,90,28
250173687001,1212,800,120,6,55,5,187,39,832,644,110,2,54,0,5,17,380,156,10,4,1,5,182,22
250173687002,1250,799,88,9,30,4,269,51,761,611,81,0,30,4,4,31,489,188,7,9,0,0,265,20
250173688001,594,286,66,7,33,0,166,36,265,149,61,0,32,0,1,22,329,137,5,7,1,0,165,14
250173688002,983,654,74,1,81,0,125,48,740,560,72,0,80,0,7,21,243,94,2,1,1,0,118,27
250173688003,1152,1007,35,2,58,0,41,9,1066,966,33,2,58,0,4,3,86,41,2,0,0,0,37,6
250173688004,924,754,62,2,59,4,37,6,821,702,53,2,58,3,0,3,103,52,9,0,1,1,37,3
250173688005,1088,651,122,5,88,5,188,29,717,484,120,2,88,0,5,18,371,167,2,3,0,5,183,11
250173689011,2788,2360,77,4,238,3,36,70,2624,2253,64,2,237,3,5,60,164,107,13,2,1,0,31,10
250173689012,814,740,1,12,45,0,7,9,771,717,1,0,45,0,1,7,43,23,0,12,0,0,6,2
250173689013,2395,1819,143,0,343,0,50,40,2234,1716,140,0,341,0,11,26,161,103,3,0,2,0,39,14
250173689014,804,752,8,0,35,2,1,6,785,735,8,0,35,0,1,6,19,17,0,0,0,2,0,0
250173689021,2774,1807,408,5,386,1,86,81,2547,1682,396,3,386,1,18,61,227,125,12,2,0,0,68,20
250173689022,770,536,98,1,68,0,52,15,583,403,98,1,67,0,5,9,187,133,0,0,1,0,47,6
250173689023,776,585,53,0,89,0,30,19,691,522,48,0,89,0,15,17,85,63,5,0,0,0,15,2
250173690001,1528,1254,51,2,174,0,17,30,1448,1192,47,2,174,0,4,29,80,62,4,0,0,0,13,1
250173691001,784,683,15,0,41,0,24,21,723,642,15,0,41,0,9,16,61,41,0,0,0,0,15,5
250173691002,820,721,30,2,36,0,25,6,764,690,30,2,36,0,1,5,56,31,0,0,0,0,24,1
250173691003,722,674,13,2,14,2,11,6,702,663,13,2,14,2,2,6,20,11,0,0,0,0,9,0
250173691004,1493,1376,34,0,52,0,11,20,1451,1342,33,0,52,0,4,20,42,34,1,0,0,0,7,0
250173691005,984,893,30,4,27,0,20,10,946,874,30,4,27,0,2,9,38,19,0,0,0,0,18,1
250173701011,1148,1015,30,2,61,0,19,21,1094,984,29,1,61,0,5,14,54,31,1,1,0,0,14,7
250173701012,1302,1181,21,4,42,0,20,34,1232,1140,19,1,41,0,4,27,70,41,2,3,1,0,16,7
250173701013,2273,1928,85,1,142,1,82,34,2123,1861,69,1,137,1,25,29,150,67,16,0,5,0,57,5
250173701014,1765,1429,84,4,154,0,43,51,1655,1370,78,4,152,0,13,38,110,59,6,0,2,0,30,13
250173701021,1082,932,29,0,87,0,14,20,1049,910,29,0,87,0,6,17,33,22,0,0,0,0,8,3
250173701022,1697,1262,81,2,283,0,34,35,1577,1180,80,2,282,0,4,29,120,82,1,0,1,0,30,6
250173701023,800,635,20,2,89,1,21,32,753,614,17,2,87,0,8,25,47,21,3,0,2,1,13,7
250173701024,1762,1462,44,3,179,1,32,41,1667,1393,43,3,179,0,10,39,95,69,1,0,0,1,22,2
250173701025,1410,1131,59,0,126,1,49,44,1285,1053,55,0,126,1,9,41,125,78,4,0,0,0,40,3
250173702011,1098,1023,16,0,31,0,6,22,1067,1003,15,0,31,0,0,18,31,20,1,0,0,0,6,4
250173702012,1271,1102,24,1,75,0,17,52,1222,1070,22,0,75,0,6,49,49,32,2,1,0,0,11,3
250173702013,1388,1195,37,2,108,0,14,32,1340,1156,37,1,108,0,7,31,48,39,0,1,0,0,7,1
250173702021,853,777,17,4,14,0,15,26,816,767,17,0,14,0,0,18,37,10,0,4,0,0,15,8
250173702022,951,863,24,1,26,0,16,21,900,820,22,1,26,0,12,19,51,43,2,0,0,0,4,2
250173702023,967,904,10,2,28,0,9,14,933,877,10,1,28,0,3,14,34,27,0,1,0,0,6,0
250173702024,1378,1263,18,3,61,0,21,12,1341,1235,18,3,61,0,14,10,37,28,0,0,0,0,7,2
250173703001,223,145,6,1,38,1,14,18,200,140,6,0,38,0,3,13,23,5,0,1,0,1,11,5
250173703002,1484,1165,48,2,144,0,43,82,1373,1104,43,2,144,0,21,59,111,61,5,0,0,0,22,23
250173703003,845,631,51,1,84,0,32,46,763,577,43,0,84,0,19,40,82,54,8,1,0,0,13,6
250173703004,1048,920,29,0,42,6,26,25,992,875,29,0,42,5,17,24,56,45,0,0,0,1,9,1
250173703005,629,549,7,1,25,0,24,23,600,532,7,0,25,0,13,23,29,17,0,1,0,0,11,0
250173703006,609,470,37,0,69,0,19,14,567,445,34,0,68,0,9,11,42,25,3,0,1,0,10,3
250173703007,806,682,37,0,44,2,9,32,774,670,30,0,44,2,2,26,32,12,7,0,0,0,7,6
250173704001,903,805,12,1,57,0,5,23,886,796,12,1,57,0,4,16,17,9,0,0,0,0,1,7
250173704002,1210,1039,38,1,79,0,32,21,1145,1001,37,1,74,0,13,19,65,38,1,0,5,0,19,2
250173704003,597,515,14,0,37,0,17,14,561,493,14,0,37,0,4,13,36,22,0,0,0,0,13,1
250173704004,764,673,25,1,32,0,14,19,719,636,25,1,31,0,9,17,45,37,0,0,1,0,5,2
250173704005,604,479,27,1,66,1,9,21,577,467,26,0,66,1,0,17,27,12,1,1,0,0,9,4
250173704006,1048,916,20,0,81,0,7,24,1016,896,17,0,81,0,4,18,32,20,3,0,0,0,3,6
250173731001,795,655,26,5,90,0,2,17,775,642,22,5,90,0,2,14,20,13,4,0,0,0,0,3
250173731002,999,795,40,2,111,1,17,33,968,779,40,2,111,1,3,32,31,16,0,0,0,0,14,1
250173731003,931,801,16,1,82,0,22,9,885,770,16,1,82,0,8,8,46,31,0,0,0,0,14,1
250173731004,872,715,30,0,86,0,19,22,842,700,29,0,86,0,6,21,30,15,1,0,0,0,13,1
250173731005,1158,927,33,0,131,0,28,39,1108,902,32,0,131,0,10,33,50,25,1,0,0,0,18,6
250173732001,1067,867,30,1,129,0,23,17,1022,846,30,1,129,0,2,14,45,21,0,0,0,0,21,3
250173732002,900,729,29,0,108,0,9,25,864,706,26,0,108,0,1,23,36,23,3,0,0,0,8,2
250173732003,855,679,19,0,123,0,17,17,804,650,10,0,123,0,7,14,51,29,9,0,0,0,10,3
250173732004,1569,1232,41,1,197,2,66,30,1432,1157,40,1,195,2,18,19,137,75,1,0,2,0,48,11
250173733001,775,682,6,0,70,0,5,12,763,675,6,0,70,0,0,12,12,7,0,0,0,0,5,0
250173733002,1182,951,43,0,145,0,8,35,1134,922,42,0,142,0,5,23,48,29,1,0,3,0,3,12
250173733003,842,651,36,0,94,0,23,38,798,637,31,0,92,0,11,27,44,14,5,0,2,0,12,11
250173734001,2088,1765,41,6,192,0,31,53,1986,1714,34,2,190,0,7,39,102,51,7,4,2,0,24,14
250173734002,1116,957,26,0,93,0,11,29,1074,927,26,0,93,0,0,28,42,30,0,0,0,0,11,1
250173735001,725,635,2,1,62,0,8,17,711,626,2,0,62,0,5,16,14,9,0,1,0,0,3,1
250173735002,1625,1390,26,0,160,2,7,40,1592,1359,25,0,160,2,6,40,33,31,1,0,0,0,1,0
250173735003,1027,943,1,1,50,1,10,21,998,920,1,0,50,1,9,17,29,23,0,1,0,0,1,4
250173735004,2810,2414,43,3,243,0,28,79,2664,2298,42,1,242,0,11,70,146,116,1,2,1,0,17,9
250173736001,2677,2133,110,2,322,2,38,70,2480,2003,102,0,319,1,2,53,197,130,8,2,3,1,36,17
250173736002,1937,1630,31,2,171,0,16,87,1797,1532,25,1,167,0,2,70,140,98,6,1,4,0,14,17
250173736003,1412,1252,20,2,113,0,6,19,1368,1212,19,0,113,0,5,19,44,40,1,2,0,0,1,0
250173737001,783,707,8,3,48,1,3,13,762,690,8,3,48,1,0,12,21,17,0,0,0,0,3,1
250173737002,1212,1068,25,2,66,0,8,43,1182,1048,23,0,66,0,6,39,30,20,2,2,0,0,2,4
250173737003,1074,953,9,0,78,0,7,27,1055,937,9,0,78,0,4,27,19,16,0,0,0,0,3,0
250173737004,721,639,7,0,46,0,1,28,715,634,7,0,46,0,1,27,6,5,0,0,0,0,0,1
250173738001,2012,1589,38,1,296,0,17,71,1933,1540,35,1,296,0,2,59,79,49,3,0,0,0,15,12
250173738002,1769,1427,63,1,224,1,7,46,1697,1372,62,1,224,1,3,34,72,55,1,0,0,0,4,12
250173738003,1479,1197,33,0,216,0,8,25,1435,1159,32,0,216,0,6,22,44,38,1,0,0,0,2,3
250173738004,663,572,6,0,70,0,9,6,639,556,5,0,70,0,2,6,24,16,1,0,0,0,7,0
250173739001,2063,1606,57,0,356,1,23,20,1988,1552,54,0,356,1,6,19,75,54,3,0,0,0,17,1
250173739002,1713,1406,23,2,234,1,2,45,1682,1379,23,2,234,1,1,42,31,27,0,0,0,0,1,3
250173739003,1554,1243,22,0,237,0,12,40,1509,1212,20,0,237,0,6,34,45,31,2,0,0,0,6,6
250173739004,1043,866,21,0,142,0,6,8,998,832,18,0,138,0,4,6,45,34,3,0,4,0,2,2
250173740001,1415,1065,29,0,295,0,6,20,1374,1030,29,0,295,0,1,19,41,35,0,0,0,0,5,1
250173740002,2492,2006,153,10,216,0,39,68,2380,1946,144,6,214,0,9,61,112,60,9,4,2,0,30,7
250173740003,1330,988,27,0,266,0,20,29,1276,955,27,0,266,0,9,19,54,33,0,0,0,0,11,10
250173741001,2041,1453,67,4,422,2,37,56,1917,1373,64,3,421,2,4,50,124,80,3,1,1,0,33,6
250173741002,1519,1153,60,0,258,2,13,33,1468,1121,58,0,257,2,3,27,51,32,2,0,1,0,10,6
250173741003,1087,748,56,2,218,0,28,35,1028,722,51,2,217,0,6,30,59,26,5,0,1,0,22,5
250173742001,945,775,18,1,131,0,8,12,921,755,17,1,131,0,5,12,24,20,1,0,0,0,3,0
250173742002,1783,1527,40,2,152,2,15,45,1696,1460,40,0,151,2,7,36,87,67,0,2,1,0,8,9
250173742003,1466,1223,44,0,156,0,14,29,1437,1201,43,0,156,0,10,27,29,22,1,0,0,0,4,2
250173743001,1192,1099,20,1,51,0,3,18,1171,1084,14,1,51,0,3,18,21,15,6,0,0,0,0,0
250173743002,1356,1210,11,1,100,0,8,26,1334,1193,11,1,100,0,3,26,22,17,0,0,0,0,5,0
250173743003,946,831,10,0,75,0,4,26,919,810,10,0,75,0,3,21,27,21,0,0,0,0,1,5
250173837004,1068,911,32,0,58,0,33,34,1000,868,30,0,58,0,15,29,68,43,2,0,0,0,18,5
250173838001,1153,964,37,1,95,1,29,26,1100,938,36,0,95,0,9,22,53,26,1,1,0,1,20,4
250173838002,1049,853,34,1,48,0,74,39,975,820,31,0,48,0,44,32,74,33,3,1,0,0,30,7
250173838003,832,742,21,0,35,0,22,12,806,729,20,0,34,0,11,12,26,13,1,0,1,0,11,0
250173838004,1410,1186,48,8,77,0,41,50,1321,1147,47,3,76,0,7,41,89,39,1,5,1,0,34,9
250173838005,916,816,18,1,37,0,13,31,873,789,14,1,37,0,4,28,43,27,4,0,0,0,9,3
250173839011,871,783,36,3,41,1,7,0,852,771,32,3,41,1,4,0,19,12,4,0,0,0,3,0
250173839012,825,769,12,0,17,0,6,21,780,734,12,0,17,0,1,16,45,35,0,0,0,0,5,5
250173839013,1394,1275,29,4,58,0,6,22,1361,1244,29,4,58,0,6,20,33,31,0,0,0,0,0,2
250173839014,1257,1117,22,1,86,0,18,13,1221,1096,22,0,85,0,8,10,36,21,0,1,1,0,10,3
250173839015,1347,1218,39,0,44,0,10,36,1301,1185,37,0,44,0,2,33,46,33,2,0,0,0,8,3
250173839016,1934,1629,98,2,108,2,54,41,1852,1572,93,1,108,1,41,36,82,57,5,1,0,1,13,5
250173839021,2504,2126,54,3,230,0,46,45,2435,2095,52,3,227,0,17,41,69,31,2,0,3,0,29,4
250173839022,1379,1168,45,2,91,0,48,25,1344,1147,44,2,91,0,37,23,35,21,1,0,0,0,11,2
250173839023,1344,1166,28,4,96,0,17,33,1299,1141,28,4,96,0,1,29,45,25,0,0,0,0,16,4
250173840011,1437,1131,57,4,148,0,65,32,1360,1092,54,0,148,0,41,25,77,39,3,4,0,0,24,7
250173840021,1976,1043,184,5,384,1,254,105,1769,953,163,2,384,1,177,89,207,90,21,3,0,0,77,16
250173840022,757,686,13,0,38,0,9,11,741,675,13,0,38,0,5,10,16,11,0,0,0,0,4,1
250173840023,2782,1975,71,1,549,0,108,78,2676,1910,64,1,549,0,79,73,106,65,7,0,0,0,29,5
250173851001,1462,1243,26,0,94,0,66,33,1397,1212,26,0,94,0,37,28,65,31,0,0,0,0,29,5
250173851002,3856,3337,64,0,363,0,23,69,3774,3273,58,0,362,0,22,59,82,64,6,0,1,0,1,10
250173851003,1399,1280,26,5,36,0,36,16,1332,1236,26,3,36,0,21,10,67,44,0,2,0,0,15,6
250173852011,1667,1484,40,2,72,3,45,21,1568,1420,36,2,72,0,21,17,99,64,4,0,0,3,24,4
250173852012,901,668,39,3,49,0,107,35,806,638,33,1,49,0,62,23,95,30,6,2,0,0,45,12
250173852021,2501,1954,47,3,382,0,66,49,2395,1879,45,3,381,0,42,45,106,75,2,0,1,0,24,4
250173852022,2491,2016,70,2,341,0,24,38,2411,1959,69,2,341,0,8,32,80,57,1,0,0,0,16,6
250173852023,1030,885,46,6,38,0,35,20,955,848,43,4,38,0,5,17,75,37,3,2,0,0,30,3
250173852024,1286,1111,33,2,77,0,35,28,1215,1065,33,1,77,0,18,21,71,46,0,1,0,0,17,7
250173861001,853,804,1,0,35,0,6,7,841,798,1,0,35,0,1,6,12,6,0,0,0,0,5,1
250173861002,1900,1797,7,0,66,0,8,22,1878,1781,7,0,66,0,4,20,22,16,0,0,0,0,4,2
250173861003,1366,1286,8,1,36,0,5,30,1343,1266,8,1,36,0,5,27,23,20,0,0,0,0,0,3
250173871001,878,815,11,2,20,0,12,18,864,805,11,2,20,0,10,16,14,10,0,0,0,0,2,2
250173871002,836,805,3,0,17,0,5,6,824,797,3,0,17,0,1,6,12,8,0,0,0,0,4,0
250173871003,1764,1699,8,0,28,0,11,18,1729,1668,8,0,28,0,7,18,35,31,0,0,0,0,4,0
250173871004,779,740,10,0,17,0,0,12,774,735,10,0,17,0,0,12,5,5,0,0,0,0,0,0
250173872011,2776,2562,43,7,107,0,25,32,2729,2526,43,6,107,0,19,28,47,36,0,1,0,0,6,4
250173872012,784,749,2,0,9,2,19,3,753,734,2,0,9,2,6,0,31,15,0,0,0,0,13,3
250173872013,863,821,5,0,20,0,5,12,853,813,5,0,20,0,3,12,10,8,0,0,0,0,2,0
250173872014,1041,988,10,1,19,0,11,12,1024,974,10,1,18,0,11,10,17,14,0,0,1,0,0,2
250173872021,1158,1103,15,1,29,0,3,7,1138,1089,14,1,26,0,1,7,20,14,1,0,3,0,2,0
250173872022,906,864,1,0,28,0,0,13,895,854,1,0,28,0,0,12,11,10,0,0,0,0,0,1
250173872023,1762,1679,10,2,43,0,14,14,1718,1650,10,2,41,0,3,12,44,29,0,0,2,0,11,2
250173881001,2837,2257,7,1,502,0,24,46,2773,2220,7,0,501,0,7,38,64,37,0,1,1,0,17,8
250173881002,1267,1043,3,1,199,0,1,20,1249,1025,3,1,199,0,1,20,18,18,0,0,0,0,0,0
250173881003,892,723,14,0,113,1,7,34,861,695,14,0,113,1,6,32,31,28,0,0,0,0,1,2
250173882001,1423,1313,39,2,22,0,16,31,1374,1284,38,2,21,0,2,27,49,29,1,0,1,0,14,4
250173882002,2635,2410,61,5,84,5,9,61,2581,2374,61,3,84,5,3,51,54,36,0,2,0,0,6,10
250173882003,3153,2490,479,9,95,1,45,34,2695,2081,475,7,95,0,6,31,458,409,4,2,0,1,39,3
250173883001,1282,578,66,8,263,0,286,81,629,301,42,0,258,0,2,26,653,277,24,8,5,0,284,55
250173883002,1264,717,70,7,188,0,239,43,870,585,51,6,185,0,18,25,394,132,19,1,3,0,221,18
250173883003,2157,1643,131,0,131,1,181,70,1789,1482,108,0,130,1,26,42,368,161,23,0,1,0,155,28
250173883004,717,241,46,1,242,3,128,56,492,163,39,1,242,3,9,35,225,78,7,0,0,0,119,21
250179800001,0,0,0,0,0,0,0,0,0,0,0,0,0,0,0,0,0,0,0,0,0,0,0,0
250199501001,881,842,24,2,5,0,5,3,865,828,24,2,5,0,4,2,16,14,0,0,0,0,1,1
250199501002,494,454,19,1,9,0,3,8,480,445,19,1,9,0,1,5,14,9,0,0,0,0,2,3
250199502001,1330,1102,133,1,33,1,25,35,1128,925,131,1,33,1,8,29,202,177,2,0,0,0,17,6
250199502002,1405,1263,77,1,15,0,24,25,1239,1127,65,1,15,0,8,23,166,136,12,0,0,0,16,2
250199502003,1435,1080,179,1,21,0,120,34,1226,965,176,1,21,0,34,29,209,115,3,0,0,0,86,5
250199502004,699,570,83,0,3,0,22,21,674,566,83,0,3,0,5,17,25,4,0,0,0,0,17,4
250199503071,342,331,1,0,2,0,4,4,338,331,1,0,2,0,0,4,4,0,0,0,0,0,4,0
250199504001,1423,1287,53,0,17,0,38,28,1307,1197,52,0,17,0,13,28,116,90,1,0,0,0,25,0
250199504002,999,864,99,0,10,0,10,16,813,701,94,0,10,0,0,8,186,163,5,0,0,0,10,8
250199505001,642,612,13,0,3,0,4,10,631,604,12,0,3,0,3,9,11,8,1,0,0,0,1,1
250199505002,522,508,7,0,0,0,5,2,514,503,7,0,0,0,3,1,8,5,0,0,0,0,2,1
250199900000,0,0,0,0,0,0,0,0,0,0,0,0,0,0,0,0,0,0,0,0,0,0,0,0
250214001001,510,405,11,2,74,0,5,13,491,393,11,0,74,0,0,13,19,12,0,2,0,0,5,0
250214001002,1033,758,63,1,164,0,22,25,958,710,62,1,163,0,2,20,75,48,1,0,1,0,20,5
250214001003,1806,1433,38,0,257,0,21,57,1715,1359,37,0,256,0,8,55,91,74,1,0,1,0,13,2
250214001004,1628,1206,123,3,205,2,27,62,1534,1147,122,2,205,1,8,49,94,59,1,1,0,1,19,13
250214002001,1644,1061,106,5,347,0,52,73,1463,952,97,5,346,0,8,55,181,109,9,0,1,0,44,18
250214002002,2835,2227,27,1,493,0,23,64,2718,2138,26,1,491,0,9,53,117,89,1,0,2,0,14,11
250214002003,1653,1219,34,0,336,0,19,45,1568,1157,33,0,335,0,7,36,85,62,1,0,1,0,12,9
250214041003,935,826,5,2,83,0,7,12,913,811,4,0,83,0,5,10,22,15,1,2,0,0,2,2
250214042011,1037,963,9,0,48,0,1,16,1026,952,9,0,48,0,1,16,11,11,0,0,0,0,0,0
250214042012,989,960,5,0,15,0,3,6,963,936,5,0,15,0,1,6,26,24,0,0,0,0,2,0
250214042013,968,890,5,1,50,0,3,19,943,871,5,0,50,0,0,17,25,19,0,1,0,0,3,2
250214042014,664,592,1,0,43,0,3,25,650,581,1,0,43,0,2,23,14,11,0,0,0,0,1,2
250214042021,1504,1341,14,2,111,0,10,26,1460,1307,14,2,109,0,2,26,44,34,0,0,2,0,8,0
250214042022,1022,933,25,0,48,0,6,10,1009,923,23,0,48,0,5,10,13,10,2,0,0,0,1,0
250214042023,2460,1922,83,2,327,1,41,84,2278,1789,75,2,326,1,8,77,182,133,8,0,1,0,33,7
250214043011,1406,1296,7,0,88,0,4,11,1379,1269,7,0,88,0,4,11,27,27,0,0,0,0,0,0
250214043012,874,801,2,1,59,0,0,11,851,778,2,1,59,0,0,11,23,23,0,0,0,0,0,0
250214043013,1295,1235,4,0,44,0,4,8,1257,1201,4,0,44,0,0,8,38,34,0,0,0,0,4,0
250214043014,1117,919,11,0,170,0,1,16,1100,902,11,0,170,0,1,16,17,17,0,0,0,0,0,0
250214043015,816,687,9,0,99,0,3,18,796,672,8,0,99,0,0,17,20,15,1,0,0,0,3,1
250214043021,1845,1610,27,0,174,0,2,32,1789,1556,27,0,174,0,0,32,56,54,0,0,0,0,2,0
250214043022,694,572,7,0,98,0,4,13,671,552,7,0,98,0,1,13,23,20,0,0,0,0,3,0
250214043023,990,868,7,1,90,0,0,24,973,852,7,0,90,0,0,24,17,16,0,1,0,0,0,0
250214044001,1088,992,20,0,39,0,8,29,1071,982,20,0,39,0,5,25,17,10,0,0,0,0,3,4
250214044002,671,645,6,0,15,0,1,4,654,629,6,0,15,0,0,4,17,16,0,0,0,0,1,0
250214044003,796,766,0,0,23,5,0,2,773,748,0,0,23,0,0,2,23,18,0,0,0,5,0,0
250214044004,851,787,12,0,32,0,6,14,835,775,9,0,32,0,6,13,16,12,3,0,0,0,0,1
250214044005,2870,1863,179,13,636,1,58,120,2651,1747,169,7,627,0,7,94,219,116,10,6,9,1,51,26
250214051001,741,689,3,0,43,0,4,2,726,679,2,0,43,0,0,2,15,10,1,0,0,0,4,0
250214051002,2231,2036,27,1,126,0,6,35,2200,2013,25,1,123,0,4,34,31,23,2,0,3,0,2,1
250214051003,1783,1647,7,2,85,4,3,35,1754,1624,7,2,85,3,2,31,29,23,0,0,0,1,1,4
250214051004,834,786,0,4,34,0,5,5,826,783,0,4,34,0,0,5,8,3,0,0,0,0,5,0
250214061011,2590,2418,42,3,81,0,7,39,2538,2375,41,3,81,0,3,35,52,43,1,0,0,0,4,4
250214061012,1281,1223,1,0,29,0,11,17,1255,1209,1,0,29,0,2,14,26,14,0,0,0,0,9,3
250214061013,1666,1617,4,0,36,0,0,9,1651,1602,4,0,36,0,0,9,15,15,0,0,0,0,0,0
250214061021,2040,1921,15,1,67,0,9,27,2004,1895,15,0,67,0,3,24,36,26,0,1,0,0,6,3
250214061022,1121,1061,1,0,48,0,0,11,1112,1052,1,0,48,0,0,11,9,9,0,0,0,0,0,0
250214061023,1138,1092,6,3,29,0,5,3,1119,1075,5,3,29,0,4,3,19,17,1,0,0,0,1,0
250214061024,2188,2103,5,2,35,0,8,35,2165,2085,5,2,35,0,3,35,23,18,0,0,0,0,5,0
250214071001,1224,1184,7,0,11,1,2,19,1200,1165,7,0,11,0,0,17,24,19,0,0,0,1,2,2
250214071002,1674,1571,8,4,63,0,5,23,1656,1555,8,3,63,0,4,23,18,16,0,1,0,0,1,0
250214071003,1894,1739,24,11,74,0,14,32,1849,1698,22,11,74,0,12,32,45,41,2,0,0,0,2,0
250214071004,1207,1137,15,3,37,0,5,10,1187,1123,14,3,37,0,0,10,20,14,1,0,0,0,5,0
250214071005,1892,1799,6,4,53,0,9,21,1863,1774,6,4,53,0,5,21,29,25,0,0,0,0,4,0
250214081011,2326,2276,19,1,23,1,1,5,2285,2239,17,0,23,1,0,5,41,37,2,1,0,0,1,0
250214081012,1580,1507,5,4,29,0,4,31,1549,1482,5,3,29,0,2,28,31,25,0,1,0,0,2,3
250214081013,3071,2866,32,6,113,0,13,41,3026,2830,32,3,113,0,7,41,45,36,0,3,0,0,6,0
250214081014,985,934,13,1,27,0,0,10,968,917,13,1,27,0,0,10,17,17,0,0,0,0,0,0
250214081021,1087,1041,11,1,26,0,0,8,1072,1026,11,1,26,0,0,8,15,15,0,0,0,0,0,0
250214081022,1777,1681,21,5,24,0,18,28,1723,1656,20,2,21,0,0,24,54,25,1,3,3,0,18,4
250214081023,984,926,15,10,15,0,1,17,949,904,11,8,15,0,0,11,35,22,4,2,0,0,1,6
250214081024,942,878,15,2,23,0,3,21,930,870,15,2,23,0,1,19,12,8,0,0,0,0,2,2
250214091011,2330,2264,14,1,21,0,6,24,2303,2247,13,1,21,0,3,18,27,17,1,0,0,0,3,6
250214091012,923,892,4,3,11,0,2,11,910,887,4,0,11,0,0,8,13,5,0,3,0,0,2,3
250214091013,2964,2029,669,21,58,0,172,15,2257,1569,616,15,53,0,1,3,707,460,53,6,5,0,171,12
250214091021,2298,2223,21,0,33,0,1,20,2273,2199,21,0,33,0,1,19,25,24,0,0,0,0,0,1
250214091022,2712,2615,12,7,51,0,4,23,2682,2591,12,5,51,0,0,23,30,24,0,2,0,0,4,0
250214101001,933,898,12,2,11,0,1,9,926,891,12,2,11,0,1,9,7,7,0,0,0,0,0,0
250214101002,2454,2340,30,9,30,2,20,23,2419,2320,30,9,30,2,8,20,35,20,0,0,0,0,12,3
250214101003,774,752,4,0,10,0,3,5,765,743,4,0,10,0,3,5,9,9,0,0,0,0,0,0
250214101004,1981,1868,37,8,34,0,5,29,1951,1848,36,8,34,0,1,24,30,20,1,0,0,0,4,5
250214103001,1969,1822,34,1,86,0,8,18,1954,1814,34,0,86,0,2,18,15,8,0,1,0,0,6,0
250214103002,2454,2289,43,0,86,0,15,21,2397,2243,37,0,86,0,10,21,57,46,6,0,0,0,5,0
250214104001,1221,1154,14,0,39,0,2,12,1204,1141,13,0,39,0,0,11,17,13,1,0,0,0,2,1
250214104002,1381,1300,12,0,40,0,13,16,1356,1287,11,0,40,0,4,14,25,13,1,0,0,0,9,2
250214104003,750,724,9,1,6,0,2,8,735,714,9,0,6,0,2,4,15,10,0,1,0,0,0,4
250214104004,1016,898,43,1,39,0,10,25,989,881,43,1,39,0,3,22,27,17,0,0,0,0,7,3
250214104005,1932,1620,86,5,158,2,25,36,1860,1583,78,5,158,2,9,25,72,37,8,0,0,0,16,11
250214111001,1523,1465,4,0,21,0,11,22,1495,1449,4,0,21,0,3,18,28,16,0,0,0,0,8,4
250214111002,1579,1255,192,12,50,0,45,25,1482,1200,184,12,50,0,17,19,97,55,8,0,0,0,28,6
250214111003,1688,1640,15,0,13,0,9,11,1652,1618,13,0,13,0,0,8,36,22,2,0,0,0,9,3
250214111004,1468,1406,20,1,32,0,2,7,1447,1389,19,1,31,0,1,6,21,17,1,0,1,0,1,1
250214111005,1714,1653,6,2,30,0,11,12,1675,1624,6,2,30,0,1,12,39,29,0,0,0,0,10,0
250214112001,1431,1385,16,2,10,1,1,16,1407,1373,10,0,10,1,0,13,24,12,6,2,0,0,1,3
250214112002,2662,2548,37,0,31,0,19,27,2617,2516,33,0,31,0,13,24,45,32,4,0,0,0,6,3
250214112003,1533,1216,45,1,251,0,1,19,1509,1197,42,0,251,0,0,19,24,19,3,1,0,0,1,0
250214112004,936,887,18,0,15,0,8,8,892,855,16,0,14,0,3,4,44,32,2,0,1,0,5,4
250214113011,3080,2977,18,2,45,0,12,26,3045,2948,17,2,45,0,7,26,35,29,1,0,0,0,5,0
250214113012,1167,1128,9,1,15,0,10,4,1160,1122,9,1,15,0,9,4,7,6,0,0,0,0,1,0
250214113013,1280,1206,27,0,24,0,6,17,1259,1193,27,0,24,0,0,15,21,13,0,0,0,0,6,2
250214113021,797,767,9,0,12,0,0,9,790,762,8,0,12,0,0,8,7,5,1,0,0,0,0,1
250214003001,936,772,9,2,109,0,7,37,895,741,9,2,108,0,2,33,41,31,0,0,1,0,5,4
250214003002,1615,1266,35,1,239,0,30,44,1528,1207,34,1,239,0,6,41,87,59,1,0,0,0,24,3
250214003003,1559,1207,43,2,228,0,15,64,1499,1169,33,1,227,0,7,62,60,38,10,1,1,0,8,2
250214004001,2198,1812,47,1,267,0,22,49,2116,1755,47,1,266,0,3,44,82,57,0,0,1,0,19,5
250214004002,2314,1880,22,3,341,0,19,49,2208,1798,22,3,339,0,3,43,106,82,0,0,2,0,16,6
250214004003,937,772,14,0,104,0,19,28,895,750,14,0,104,0,3,24,42,22,0,0,0,0,16,4
250214005001,2419,2000,42,7,279,0,27,64,2304,1913,38,0,279,0,12,62,115,87,4,7,0,0,15,2
250214005002,1271,1048,20,3,165,0,7,28,1202,993,20,2,165,0,0,22,69,55,0,1,0,0,7,6
250214005003,1483,1267,41,0,128,1,12,34,1430,1226,41,0,128,1,2,32,53,41,0,0,0,0,10,2
250214006001,1424,1108,27,4,234,0,12,39,1365,1067,25,3,231,0,5,34,59,41,2,1,3,0,7,5
250214006002,2883,2347,38,2,398,0,26,72,2761,2254,35,1,396,0,8,67,122,93,3,1,2,0,18,5
250214006003,870,718,57,1,64,0,11,19,834,699,49,1,64,0,3,18,36,19,8,0,0,0,8,1
250214007001,1296,1007,27,1,192,0,16,53,1239,968,24,1,192,0,7,47,57,39,3,0,0,0,9,6
250214007002,1344,1029,46,1,185,0,31,52,1256,981,41,1,185,0,6,42,88,48,5,0,0,0,25,10
250214007003,958,762,19,0,123,0,4,50,934,741,19,0,123,0,2,49,24,21,0,0,0,0,2,1
250214008001,1117,757,24,3,283,1,8,41,1084,734,23,2,283,1,3,38,33,23,1,1,0,0,5,3
250214008002,1727,1345,41,4,261,0,18,58,1635,1279,41,3,259,0,8,45,92,66,0,1,2,0,10,13
250214008003,2786,2050,106,2,526,8,17,77,2639,1944,98,1,526,7,3,60,147,106,8,1,0,1,14,17
250214009001,1668,915,83,1,585,0,33,51,1548,848,71,1,582,0,2,44,120,67,12,0,3,0,31,7
250214009002,549,334,161,2,14,0,14,24,498,314,147,1,14,0,4,18,51,20,14,1,0,0,10,6
250214009003,1648,1313,22,1,255,0,10,47,1577,1262,19,0,254,0,1,41,71,51,3,1,1,0,9,6
250214010001,928,733,33,1,108,0,20,33,863,686,32,0,108,0,7,30,65,47,1,1,0,0,13,3
250214010002,666,557,21,0,62,0,1,25,652,550,21,0,62,0,1,18,14,7,0,0,0,0,0,7
250214010003,1555,996,139,5,291,0,50,74,1387,905,127,2,290,0,4,59,168,91,12,3,1,0,46,15
250214011001,1880,1615,45,1,173,0,10,36,1818,1570,38,1,173,0,5,31,62,45,7,0,0,0,5,5
250214011002,1075,869,27,1,150,0,3,25,1024,830,25,1,149,0,0,19,51,39,2,0,1,0,3,6
250214011003,1486,1166,52,0,210,0,21,37,1427,1130,50,0,210,0,7,30,59,36,2,0,0,0,14,7
250214012001,1849,1395,207,1,140,0,40,66,1721,1342,178,1,139,0,13,48,128,53,29,0,1,0,27,18
250214012002,1308,1068,35,4,151,0,17,33,1257,1035,32,3,151,0,7,29,51,33,3,1,0,0,10,4
250214012003,2108,1322,59,0,654,2,27,44,2036,1278,54,0,653,2,5,44,72,44,5,0,1,0,22,0
250214012004,1766,1282,33,1,388,0,10,52,1689,1215,33,0,388,0,6,47,77,67,0,1,0,0,4,5
250214021011,595,550,16,0,17,0,9,3,565,531,16,0,14,0,1,3,30,19,0,0,3,0,8,0
250214021012,1031,873,79,5,34,0,18,22,967,844,72,0,34,0,8,9,64,29,7,5,0,0,10,13
250214021013,648,599,15,0,18,0,2,14,618,573,14,0,18,0,1,12,30,26,1,0,0,0,1,2
250214021014,1360,1209,36,14,59,0,16,26,1291,1162,36,13,56,0,2,22,69,47,0,1,3,0,14,4
250214021021,930,755,89,2,34,0,21,29,872,723,83,2,34,0,5,25,58,32,6,0,0,0,16,4
250214021022,1215,993,101,3,35,0,54,29,1099,935,100,2,35,0,5,22,116,58,1,1,0,0,49,7
250214021023,747,580,102,7,11,0,36,11,672,547,93,5,11,0,7,9,75,33,9,2,0,0,29,2
250214021024,1171,970,113,8,32,0,22,26,1076,915,102,7,32,0,6,14,95,55,11,1,0,0,16,12
250214022001,855,750,47,3,15,1,28,11,772,702,46,1,15,1,0,7,83,48,1,2,0,0,28,4
250214022002,1314,1199,42,2,41,0,16,14,1241,1141,42,2,41,0,3,12,73,58,0,0,0,0,13,2
250214023001,823,740,15,0,35,0,6,27,793,722,11,0,35,0,4,21,30,18,4,0,0,0,2,6
250214023002,1437,1334,23,0,46,1,19,14,1386,1303,19,0,44,1,5,14,51,31,4,0,2,0,14,0
250214023003,2289,2155,50,3,41,0,9,31,2221,2108,50,1,41,0,2,19,68,47,0,2,0,0,7,12
250214024001,828,717,49,4,21,0,13,24,751,667,45,4,21,0,1,13,77,50,4,0,0,0,12,11
250214024002,752,673,36,0,7,0,12,24,714,648,36,0,7,0,4,19,38,25,0,0,0,0,8,5
250214024003,912,860,27,0,4,0,10,11,897,855,27,0,4,0,4,7,15,5,0,0,0,0,6,4
250214024004,820,777,22,0,3,0,10,8,796,765,22,0,3,0,3,3,24,12,0,0,0,0,7,5
250214024005,671,642,3,1,19,0,6,0,653,630,3,1,19,0,0,0,18,12,0,0,0,0,6,0
250214024006,2067,1595,239,7,108,0,73,45,1923,1539,225,4,108,0,11,36,144,56,14,3,0,0,62,9
250214025001,1233,1152,32,1,25,0,10,13,1192,1124,29,0,25,0,1,13,41,28,3,1,0,0,9,0
250214025002,3031,2735,208,5,35,2,12,34,2877,2613,197,4,35,2,1,25,154,122,11,1,0,0,11,9
250214031001,765,720,0,0,31,0,2,12,748,706,0,0,30,0,2,10,17,14,0,0,1,0,0,2
250214031002,1025,898,8,1,103,0,2,13,1011,884,8,1,103,0,2,13,14,14,0,0,0,0,0,0
250214031003,725,672,7,0,35,0,1,10,704,652,7,0,35,0,0,10,21,20,0,0,0,0,1,0
250214031004,1204,1109,8,0,60,0,3,24,1176,1084,8,0,60,0,0,24,28,25,0,0,0,0,3,0
250214031005,1055,985,1,0,55,0,5,9,1042,972,1,0,55,0,5,9,13,13,0,0,0,0,0,0
250214031006,1178,1156,1,0,16,0,1,4,1156,1136,1,0,16,0,0,3,22,20,0,0,0,0,1,1
250214031007,889,843,0,0,33,0,4,9,873,831,0,0,33,0,1,8,16,12,0,0,0,0,3,1
250214033001,1184,1101,15,0,52,0,5,11,1169,1086,15,0,52,0,5,11,15,15,0,0,0,0,0,0
250214033002,1001,931,1,3,51,0,0,15,978,908,1,3,51,0,0,15,23,23,0,0,0,0,0,0
250214033003,2037,1897,25,0,67,1,11,36,1976,1847,25,0,66,1,4,33,61,50,0,0,1,0,7,3
250214034001,1264,1152,9,1,72,0,3,27,1241,1131,9,1,72,0,2,26,23,21,0,0,0,0,1,1
250214034002,1286,1195,7,0,68,0,0,16,1279,1188,7,0,68,0,0,16,7,7,0,0,0,0,0,0
250214034003,1436,1185,71,1,123,0,16,40,1360,1140,58,1,122,0,3,36,76,45,13,0,1,0,13,4
250214034004,716,666,2,1,36,0,0,11,698,648,2,1,36,0,0,11,18,18,0,0,0,0,0,0
250214034005,1786,1612,14,1,121,1,5,32,1750,1583,14,1,120,1,0,31,36,29,0,0,1,0,5,1
250214035001,1648,1423,26,0,164,0,12,23,1620,1406,26,0,164,0,3,21,28,17,0,0,0,0,9,2
250214035002,1520,1260,48,1,158,0,10,43,1473,1227,48,1,156,0,5,36,47,33,0,0,2,0,5,7
250214035003,2516,2259,9,0,179,6,13,50,2458,2211,9,0,179,6,4,49,58,48,0,0,0,0,9,1
250214041001,1945,1456,114,14,289,0,25,47,1832,1375,114,10,288,0,2,43,113,81,0,4,1,0,23,4
250214041002,1145,893,19,0,175,0,7,51,1088,853,19,0,174,0,0,42,57,40,0,0,1,0,7,9
250173744001,1237,1095,13,1,103,0,4,21,1204,1067,13,1,102,0,1,20,33,28,0,0,1,0,3,1
250173744002,849,741,14,0,53,0,5,36,807,719,11,0,51,0,1,25,42,22,3,0,2,0,4,11
250173744003,938,813,5,1,99,0,2,18,911,787,5,0,99,0,2,18,27,26,0,1,0,0,0,0
250173744004,1681,1400,34,0,204,1,4,38,1639,1364,33,0,204,1,3,34,42,36,1,0,0,0,1,4
250173744005,1038,910,21,1,59,0,15,32,1003,893,14,1,59,0,7,29,35,17,7,0,0,0,8,3
250173745001,790,590,68,3,99,0,6,24,762,569,67,1,99,0,3,23,28,21,1,2,0,0,3,1
250173745002,1239,955,54,1,168,0,29,32,1154,909,51,1,168,0,2,23,85,46,3,0,0,0,27,9
250173745003,782,685,8,1,68,0,3,17,766,674,8,0,68,0,0,16,16,11,0,1,0,0,3,1
250173745004,802,649,15,4,101,0,8,25,738,596,13,4,101,0,0,24,64,53,2,0,0,0,8,1
250173745005,726,675,3,1,21,0,6,20,702,659,3,0,21,0,0,19,24,16,0,1,0,0,6,1
250173746001,1416,1185,32,2,150,0,24,23,1352,1149,30,1,149,0,7,16,64,36,2,1,1,0,17,7
250173746002,1216,998,38,3,99,0,64,14,1109,948,36,1,99,0,13,12,107,50,2,2,0,0,51,2
250173746003,1274,1022,17,1,157,0,39,38,1166,962,16,0,157,0,4,27,108,60,1,1,0,0,35,11
250173746004,923,768,39,5,66,0,18,27,886,755,32,4,66,0,3,26,37,13,7,1,0,0,15,1
250173747001,2640,2108,80,3,353,0,45,51,2528,2034,79,3,353,0,9,50,112,74,1,0,0,0,36,1
250173747002,1837,1493,33,1,258,0,8,44,1781,1449,28,0,258,0,4,42,56,44,5,1,0,0,4,2
250173748001,1323,1115,63,4,100,0,12,29,1264,1075,55,3,100,0,5,26,59,40,8,1,0,0,7,3
250173748002,2262,1807,80,1,331,0,17,26,2202,1763,78,1,331,0,5,24,60,44,2,0,0,0,12,2
250173748003,1153,911,47,1,176,0,3,15,1115,891,32,0,176,0,1,15,38,20,15,1,0,0,2,0
250173821001,1389,1169,44,0,134,0,13,29,1342,1135,41,0,134,0,5,27,47,34,3,0,0,0,8,2
250173821002,926,819,18,1,69,0,4,15,912,807,18,0,69,0,3,15,14,12,0,1,0,0,1,0
250173821003,802,717,16,0,64,0,0,5,789,705,15,0,64,0,0,5,13,12,1,0,0,0,0,0
250173821004,821,720,15,0,63,0,9,14,796,705,14,0,63,0,0,14,25,15,1,0,0,0,9,0
250173821005,973,865,5,0,93,0,3,7,954,847,5,0,93,0,2,7,19,18,0,0,0,0,1,0
250173822001,1499,1332,42,8,64,0,18,35,1461,1304,42,8,64,0,8,35,38,28,0,0,0,0,10,0
250173822002,1260,1153,25,1,52,0,7,22,1218,1120,24,1,52,0,5,16,42,33,1,0,0,0,2,6
250173822003,1056,943,41,0,39,0,11,22,1025,928,34,0,39,0,5,19,31,15,7,0,0,0,6,3
250173822004,1343,1244,17,0,50,0,11,21,1296,1207,17,0,50,0,4,18,47,37,0,0,0,0,7,3
250173823001,763,704,12,5,16,0,13,13,730,686,11,4,16,0,0,13,33,18,1,1,0,0,13,0
250173823002,2415,2170,40,4,128,1,24,48,2351,2124,37,4,128,0,17,41,64,46,3,0,0,1,7,7
250173823003,909,839,6,0,33,1,5,25,886,825,5,0,33,1,1,21,23,14,1,0,0,0,4,4
250173823004,1481,1368,16,2,60,0,6,29,1448,1347,14,1,54,0,5,27,33,21,2,1,6,0,1,2
250173824001,1476,1359,20,1,38,0,29,29,1421,1335,16,1,38,0,9,22,55,24,4,0,0,0,20,7
250173824002,1798,1679,20,4,52,1,15,27,1760,1651,18,2,52,1,10,26,38,28,2,2,0,0,5,1
250173824003,1249,1187,2,0,42,0,5,13,1237,1177,2,0,42,0,3,13,12,10,0,0,0,0,2,0
250173825001,1716,1525,39,0,119,0,6,27,1674,1497,37,0,119,0,1,20,42,28,2,0,0,0,5,7
250173825002,1108,947,37,3,75,1,20,25,1061,918,37,0,72,1,10,23,47,29,0,3,3,0,10,2
250173825003,1594,1416,38,0,76,0,24,40,1541,1385,37,0,75,0,7,37,53,31,1,0,1,0,17,3
250173826011,1883,1249,49,1,471,1,57,55,1785,1198,41,1,470,1,26,48,98,51,8,0,1,0,31,7
250173826012,813,567,46,0,151,0,19,30,775,545,46,0,151,0,8,25,38,22,0,0,0,0,11,5
250173826013,1573,1248,51,4,183,0,48,39,1511,1219,51,4,183,0,22,32,62,29,0,0,0,0,26,7
250173826021,539,445,25,2,34,5,20,8,503,417,25,0,34,5,16,6,36,28,0,2,0,0,4,2
250173826022,824,688,19,0,92,0,10,15,806,682,18,0,92,0,0,14,18,6,1,0,0,0,10,1
250173826023,1424,1192,28,5,148,0,11,40,1383,1170,21,1,148,0,8,35,41,22,7,4,0,0,3,5
250173826024,1372,1277,21,1,40,0,3,30,1347,1255,21,1,40,0,1,29,25,22,0,0,0,0,2,1
250173831011,2610,1522,251,13,49,15,459,301,2063,1222,222,6,45,4,295,269,547,300,29,7,4,11,164,32
250173831012,1607,771,132,13,13,12,428,238,1011,464,77,7,10,2,253,198,596,307,55,6,3,10,175,40
250173831021,2156,1056,189,2,36,3,614,256,1514,704,165,1,34,0,387,223,642,352,24,1,2,3,227,33
250173831022,2767,1254,515,19,27,0,770,182,1056,437,341,1,25,0,141,111,1711,817,174,18,2,0,629,71
250173832001,1870,953,120,14,35,1,608,139,1163,651,100,13,35,1,257,106,707,302,20,1,0,0,351,33
250173832002,1137,810,66,7,34,0,109,111,927,707,59,0,34,0,42,85,210,103,7,7,0,0,67,26
250173832003,1208,624,73,8,16,1,399,87,880,509,70,3,16,1,219,62,328,115,3,5,0,0,180,25
250173832004,1831,1222,128,11,98,0,274,98,1500,1062,110,2,96,0,158,72,331,160,18,9,2,0,116,26
250173833001,1554,830,104,12,49,1,452,106,1281,758,86,7,49,1,302,78,273,72,18,5,0,0,150,28
250173833002,1488,1275,61,0,66,0,62,24,1409,1235,59,0,62,0,33,20,79,40,2,0,4,0,29,4
250173834001,1692,1068,117,1,165,0,244,97,1436,933,109,1,165,0,145,83,256,135,8,0,0,0,99,14
250173834002,1644,938,144,18,67,0,348,129,1361,804,122,2,65,0,258,110,283,134,22,16,2,0,90,19
250173834003,1348,735,118,8,45,3,327,112,1040,543,102,8,45,3,252,87,308,192,16,0,0,0,75,25
250173834004,856,637,58,3,34,0,87,37,761,601,51,3,34,0,47,25,95,36,7,0,0,0,40,12
250173835011,1884,1151,147,6,241,0,258,81,1689,1065,136,2,240,0,174,72,195,86,11,4,1,0,84,9
250173835012,1290,908,79,2,100,2,152,47,988,782,56,2,100,2,17,29,302,126,23,0,0,0,135,18
250173835013,1085,662,58,8,141,0,154,62,975,617,54,8,141,0,100,55,110,45,4,0,0,0,54,7
250173835021,2479,2071,119,2,62,0,136,89,2302,1987,107,1,60,0,66,81,177,84,12,1,2,0,70,8
250173835022,1294,1046,59,4,93,0,52,40,1200,994,56,2,93,0,23,32,94,52,3,2,0,0,29,8
250173836001,1542,1291,41,2,125,0,49,34,1461,1238,38,0,125,0,28,32,81,53,3,2,0,0,21,2
250173836002,681,212,180,3,41,0,209,36,547,161,180,3,41,0,134,28,134,51,0,0,0,0,75,8
250173836003,2107,1670,82,4,170,1,130,50,1968,1592,74,3,167,1,84,47,139,78,8,1,3,0,46,3
250173836004,1808,1473,99,2,149,0,52,33,1707,1430,80,2,149,0,22,24,101,43,19,0,0,0,30,9
250173837001,963,882,0,0,57,3,3,18,920,848,0,0,57,0,1,14,43,34,0,0,0,3,2,4
250173837002,566,428,28,1,69,0,15,25,534,413,27,1,69,0,1,23,32,15,1,0,0,0,14,2
250173837003,2616,2075,147,2,111,0,197,84,2398,1962,144,2,111,0,119,60,218,113,3,0,0,0,78,24
250173564001,653,587,8,0,41,0,6,11,625,562,8,0,41,0,3,11,28,25,0,0,0,0,3,0
250173564002,1176,1032,14,2,84,0,7,37,1147,1017,14,0,84,0,3,29,29,15,0,2,0,0,4,8
250173564003,926,832,12,0,58,1,6,17,901,810,12,0,58,0,5,16,25,22,0,0,0,1,1,1
250173564004,652,612,5,0,25,0,5,5,643,604,5,0,25,0,4,5,9,8,0,0,0,0,1,0
250173564005,720,680,2,1,24,0,6,7,699,665,2,1,24,0,0,7,21,15,0,0,0,0,6,0
250173564006,1234,1115,22,2,57,0,4,34,1212,1102,21,1,57,0,3,28,22,13,1,1,0,0,1,6
250173564007,748,638,16,0,76,0,4,14,738,630,16,0,76,0,2,14,10,8,0,0,0,0,2,0
250173564008,1138,1015,17,6,84,0,1,15,1110,997,15,0,84,0,0,14,28,18,2,6,0,0,1,1
250173565001,838,750,5,1,46,0,5,31,824,745,5,1,45,0,3,25,14,5,0,0,1,0,2,6
250173565002,1120,961,29,1,89,1,23,16,1077,931,29,1,88,1,13,14,43,30,0,0,1,0,10,2
250173565003,1670,1432,42,0,132,0,18,46,1629,1405,41,0,132,0,14,37,41,27,1,0,0,0,4,9
250173565004,793,663,19,1,76,0,14,20,753,639,18,1,76,0,1,18,40,24,1,0,0,0,13,2
250173565005,1189,999,17,0,114,0,21,38,1161,986,15,0,114,0,12,34,28,13,2,0,0,0,9,4
250173565006,970,847,10,1,80,0,15,17,937,829,10,0,79,0,3,16,33,18,0,1,1,0,12,1
250173566011,1701,1293,98,1,245,0,21,43,1637,1253,93,1,245,0,10,35,64,40,5,0,0,0,11,8
250173566012,1096,971,9,4,59,0,7,46,1059,946,9,4,59,0,2,39,37,25,0,0,0,0,5,7
250173566013,670,614,2,1,41,0,0,12,656,603,2,0,41,0,0,10,14,11,0,1,0,0,0,2
250173566014,749,688,9,0,39,0,6,7,727,673,8,0,39,0,0,7,22,15,1,0,0,0,6,0
250173566021,1569,1345,46,2,127,0,18,31,1521,1315,43,2,126,0,12,23,48,30,3,0,1,0,6,8
250173566022,792,690,13,0,58,0,3,28,777,681,12,0,58,0,0,26,15,9,1,0,0,0,3,2
250173566023,805,740,6,0,46,0,1,12,789,726,6,0,46,0,0,11,16,14,0,0,0,0,1,1
250173566024,1003,899,32,1,38,0,20,13,971,884,32,1,38,0,7,9,32,15,0,0,0,0,13,4
250173567011,1316,1136,47,0,88,0,7,38,1257,1096,46,0,88,0,6,21,59,40,1,0,0,0,1,17
250173567012,1131,932,29,2,114,0,16,38,1083,901,27,1,114,0,8,32,48,31,2,1,0,0,8,6
250173567013,1310,981,43,2,235,0,15,34,1265,960,38,1,234,0,4,28,45,21,5,1,1,0,11,6
250173567014,690,550,16,0,107,0,5,12,663,529,16,0,107,0,0,11,27,21,0,0,0,0,5,1
250173567015,621,550,9,0,48,0,0,14,607,537,8,0,48,0,0,14,14,13,1,0,0,0,0,0
250173567016,776,682,10,1,59,0,4,20,755,667,9,1,59,0,1,18,21,15,1,0,0,0,3,2
250173567021,1316,1111,30,4,111,0,18,42,1252,1065,29,4,111,0,4,39,64,46,1,0,0,0,14,3
250173567022,918,853,0,1,40,0,2,22,895,837,0,0,40,0,0,18,23,16,0,1,0,0,2,4
250173567023,1532,1292,43,7,150,0,9,31,1489,1263,41,3,149,0,5,28,43,29,2,4,1,0,4,3
250173567024,756,658,12,0,53,1,7,25,740,646,12,0,52,1,5,24,16,12,0,0,1,0,2,1
250173567025,775,693,11,1,43,0,5,22,757,677,11,1,43,0,3,22,18,16,0,0,0,0,2,0
250173567026,759,686,9,0,48,0,1,15,754,681,9,0,48,0,1,15,5,5,0,0,0,0,0,0
250173567027,582,439,28,0,85,0,11,19,552,423,27,0,85,0,9,8,30,16,1,0,0,0,2,11
250173571001,940,855,5,0,61,0,5,14,918,833,5,0,61,0,5,14,22,22,0,0,0,0,0,0
250173571002,1374,1052,18,0,272,0,4,28,1339,1024,18,0,272,0,0,25,35,28,0,0,0,0,4,3
250173571003,907,807,2,2,72,0,1,23,895,801,2,2,70,0,0,20,12,6,0,0,2,0,1,3
250173571004,964,862,4,2,74,0,3,19,940,841,4,2,74,0,0,19,24,21,0,0,0,0,3,0
250173572001,1083,814,26,1,193,0,10,39,1022,773,25,1,193,0,3,27,61,41,1,0,0,0,7,12
250173572002,751,655,2,0,73,0,0,21,734,640,2,0,73,0,0,19,17,15,0,0,0,0,0,2
250173572003,738,674,2,0,50,0,0,12,723,659,2,0,50,0,0,12,15,15,0,0,0,0,0,0
250173572004,630,563,3,1,41,0,3,19,625,558,3,1,41,0,3,19,5,5,0,0,0,0,0,0
250173573001,927,809,3,0,82,0,11,22,901,788,3,0,82,0,9,19,26,21,0,0,0,0,2,3
250173573002,1046,816,30,4,151,1,13,31,997,788,30,0,148,1,5,25,49,28,0,4,3,0,8,6
250173573003,1000,835,24,1,113,0,3,24,978,819,21,0,113,0,1,24,22,16,3,1,0,0,2,0
250173574001,791,685,13,0,50,0,17,26,751,664,12,0,50,0,4,21,40,21,1,0,0,0,13,5
250173574002,738,633,7,0,76,0,9,13,717,617,7,0,76,0,6,11,21,16,0,0,0,0,3,2
250173574003,810,728,9,0,43,0,2,28,785,708,9,0,43,0,0,25,25,20,0,0,0,0,2,3
250173575001,634,552,7,0,60,0,2,13,628,548,7,0,59,0,1,13,6,4,0,0,1,0,1,0
250173575002,657,542,4,0,81,0,6,24,624,519,4,0,81,0,0,20,33,23,0,0,0,0,6,4
250173575003,839,690,10,2,101,0,6,30,819,684,10,0,101,0,3,21,20,6,0,2,0,0,3,9
250173576001,966,763,16,2,160,0,5,20,935,739,15,2,158,0,1,20,31,24,1,0,2,0,4,0
250173576002,1466,1185,45,0,179,1,27,29,1424,1168,45,0,178,1,5,27,42,17,0,0,1,0,22,2
250173577001,935,796,34,1,80,0,6,18,914,782,34,0,80,0,1,17,21,14,0,1,0,0,5,1
250173577002,811,645,43,2,92,0,9,20,781,622,43,0,92,0,8,16,30,23,0,2,0,0,1,4
250173577003,955,718,32,1,162,0,11,31,919,697,32,1,162,0,0,27,36,21,0,0,0,0,11,4
250173577004,1026,798,26,4,143,1,21,33,981,765,26,4,143,1,12,30,45,33,0,0,0,0,9,3
250173578001,936,814,1,1,97,0,3,20,922,803,1,1,96,0,2,19,14,11,0,0,1,0,1,1
250173578002,853,766,8,3,46,0,8,22,829,748,8,3,46,0,2,22,24,18,0,0,0,0,6,0
250173578003,1030,908,13,0,72,0,0,37,1002,884,13,0,72,0,0,33,28,24,0,0,0,0,0,4
250173578004,922,674,68,1,111,0,17,51,872,646,62,1,110,0,9,44,50,28,6,0,1,0,8,7
250173581001,967,790,10,0,120,0,3,44,953,779,9,0,120,0,3,42,14,11,1,0,0,0,0,2
250173581002,1284,1045,28,1,169,0,3,38,1254,1021,28,0,169,0,2,34,30,24,0,1,0,0,1,4
250173581003,1522,1256,22,0,226,0,1,17,1482,1216,22,0,226,0,1,17,40,40,0,0,0,0,0,0
250173581004,1332,984,17,1,298,0,8,24,1313,973,17,1,298,0,6,18,19,11,0,0,0,0,2,6
250173583001,3590,2335,129,3,995,2,23,103,3470,2232,126,3,995,2,15,97,120,103,3,0,0,0,8,6
250173583002,1936,1491,18,0,346,0,6,75,1907,1468,18,0,346,0,2,73,29,23,0,0,0,0,4,2
250173584001,925,776,2,0,126,0,2,19,908,762,1,0,126,0,0,19,17,14,1,0,0,0,2,0
250173584002,1267,1106,14,0,108,0,9,30,1237,1082,14,0,108,0,6,27,30,24,0,0,0,0,3,3
250173584003,1662,1210,20,0,382,0,6,44,1621,1178,20,0,382,0,1,40,41,32,0,0,0,0,5,4
250173584004,1041,731,22,0,275,0,4,9,1009,704,21,0,275,0,1,8,32,27,1,0,0,0,3,1
250173585001,2176,1670,14,3,421,0,10,58,2128,1634,13,3,421,0,4,53,48,36,1,0,0,0,6,5
250173585002,741,539,19,2,140,0,4,37,729,531,18,2,140,0,4,34,12,8,1,0,0,0,0,3
250173585003,1944,1417,15,4,462,0,16,30,1903,1387,15,2,462,0,9,28,41,30,0,2,0,0,7,2
250173586001,1200,946,12,3,216,0,4,19,1173,923,12,3,215,0,3,17,27,23,0,0,1,0,1,2
250173586002,797,508,18,1,241,0,2,27,774,493,13,0,241,0,1,26,23,15,5,1,0,0,1,1
250173586003,697,574,5,0,88,1,1,28,672,556,4,0,88,1,0,23,25,18,1,0,0,0,1,5
250173586004,1131,836,11,3,237,0,21,23,1106,824,11,3,237,0,10,21,25,12,0,0,0,0,11,2
250173586005,869,631,9,0,201,0,6,22,862,627,9,0,201,0,3,22,7,4,0,0,0,0,3,0
250173586006,1253,979,8,1,228,0,1,36,1232,959,8,1,228,0,0,36,21,20,0,0,0,0,1,0
250173587001,2062,1417,57,2,515,0,8,63,2009,1378,56,2,515,0,2,56,53,39,1,0,0,0,6,7
250173587002,1435,1082,20,0,296,0,3,34,1401,1051,20,0,296,0,1,33,34,31,0,0,0,0,2,1
250173587003,1563,1382,3,1,150,0,5,22,1538,1360,2,1,150,0,3,22,25,22,1,0,0,0,2,0
250173591001,1295,1142,18,0,124,0,0,11,1277,1128,14,0,124,0,0,11,18,14,4,0,0,0,0,0
250173591002,1079,949,9,0,90,1,6,24,1052,928,9,0,90,1,0,24,27,21,0,0,0,0,6,0
250173591003,1825,1569,67,3,133,0,11,42,1780,1537,67,3,133,0,3,37,45,32,0,0,0,0,8,5
250173591004,1999,1657,62,1,214,2,20,43,1908,1608,56,0,214,2,1,27,91,49,6,1,0,0,19,16
250173593001,947,827,34,1,60,0,5,20,935,820,34,1,60,0,2,18,12,7,0,0,0,0,3,2
250173593002,936,796,41,2,71,2,2,22,892,759,37,2,71,0,1,22,44,37,4,0,0,2,1,0
250173593003,1581,1351,24,0,184,2,2,18,1555,1328,24,0,184,0,1,18,26,23,0,0,0,2,1,0
250173593004,2683,2343,37,11,243,0,1,48,2630,2298,33,11,243,0,0,45,53,45,4,0,0,0,1,3
250173593005,975,809,9,1,131,0,7,18,935,778,8,0,131,0,2,16,40,31,1,1,0,0,5,2
250173601001,1286,962,147,9,44,3,35,86,1094,843,129,6,41,3,2,70,192,119,18,3,3,0,33,16
250173602001,881,728,27,0,92,2,6,26,857,711,21,0,92,2,6,25,24,17,6,0,0,0,0,1
250173602002,1173,1062,22,1,59,0,4,25,1155,1047,22,1,58,0,3,24,18,15,0,0,1,0,1,1
250173602003,1260,1149,19,3,55,1,8,25,1228,1123,19,3,55,1,6,21,32,26,0,0,0,0,2,4
250173602004,1762,1575,38,0,101,0,14,34,1712,1542,33,0,101,0,4,32,50,33,5,0,0,0,10,2
250173611001,1071,1005,3,0,50,0,3,10,1056,993,3,0,50,0,0,10,15,12,0,0,0,0,3,0
250173611002,1476,1390,13,1,52,0,3,17,1458,1376,13,0,52,0,3,14,18,14,0,1,0,0,0,3
250173611003,959,926,6,1,16,0,0,10,942,909,6,1,16,0,0,10,17,17,0,0,0,0,0,0
250173611004,1327,1262,11,1,40,0,1,12,1310,1246,11,0,40,0,1,12,17,16,0,1,0,0,0,0
250173611005,824,782,2,1,19,0,9,11,808,772,2,1,19,0,4,10,16,10,0,0,0,0,5,1
250173612001,2854,2132,449,1,141,0,91,40,2530,1914,432,1,141,0,11,31,324,218,17,0,0,0,80,9
250173612002,1035,964,8,0,41,0,7,15,1024,957,8,0,41,0,3,15,11,7,0,0,0,0,4,0
250173612003,1876,1733,22,0,94,0,4,23,1846,1707,22,0,94,0,2,21,30,26,0,0,0,0,2,2
250173613001,1135,1021,21,1,56,0,4,32,1106,1008,19,1,56,0,3,19,29,13,2,0,0,0,1,13
250173613002,1370,1311,19,2,11,0,6,21,1352,1299,19,2,11,0,5,16,18,12,0,0,0,0,1,5
250173613003,1160,994,20,2,101,0,1,42,1137,972,20,2,101,0,0,42,23,22,0,0,0,0,1,0
250173613004,1791,1579,97,4,63,0,35,13,1671,1508,91,0,62,0,0,10,120,71,6,4,1,0,35,3
250173613005,790,751,2,0,25,0,6,6,773,741,2,0,25,0,0,5,17,10,0,0,0,0,6,1
250173621001,2613,2252,14,0,268,0,10,69,2562,2220,8,0,268,0,5,61,51,32,6,0,0,0,5,8
250173621002,2239,2078,6,1,113,1,12,28,2190,2037,6,1,112,1,5,28,49,41,0,0,1,0,7,0
250173631021,1330,1086,23,1,170,0,32,18,1273,1043,23,1,170,0,21,15,57,43,0,0,0,0,11,3
250173631022,2118,1274,20,4,698,0,78,44,2046,1230,20,2,698,0,56,40,72,44,0,2,0,0,22,4
250173631023,2461,1689,60,2,620,0,34,56,2375,1632,59,2,619,0,18,45,86,57,1,0,1,0,16,11
250173631031,2069,1603,42,0,353,0,25,46,2013,1563,40,0,353,0,19,38,56,40,2,0,0,0,6,8
250173631032,1160,970,4,2,165,0,7,12,1136,954,4,0,165,0,2,11,24,16,0,2,0,0,5,1
250173631041,2602,1850,33,1,666,0,24,28,2548,1814,32,1,666,0,11,24,54,36,1,0,0,0,13,4
250173631042,883,812,8,0,46,0,9,8,847,786,7,0,46,0,0,8,36,26,1,0,0,0,9,0
250173631043,1841,1412,23,1,349,3,11,42,1800,1384,22,1,347,3,5,38,41,28,1,0,2,0,6,4
250173631044,779,657,2,0,108,0,5,7,767,649,2,0,108,0,3,5,12,8,0,0,0,0,2,2
250173632011,968,852,2,1,88,0,6,19,951,841,2,0,88,0,3,17,17,11,0,1,0,0,3,2
250173632012,1388,1095,1,0,264,0,4,24,1358,1066,1,0,264,0,3,24,30,29,0,0,0,0,1,0
250173632013,863,742,3,2,103,0,0,13,849,728,3,2,103,0,0,13,14,14,0,0,0,0,0,0
250173632021,694,605,5,2,78,0,1,3,683,595,5,2,78,0,0,3,11,10,0,0,0,0,1,0
250173632022,1223,943,9,2,210,0,20,39,1200,933,9,2,208,0,11,37,23,10,0,0,2,0,9,2
250173632023,1545,1363,3,0,149,0,7,23,1518,1337,3,0,149,0,7,22,27,26,0,0,0,0,0,1
250173641011,2002,1819,44,6,47,1,50,35,1865,1734,41,6,47,1,13,23,137,85,3,0,0,0,37,12
250173641012,1300,1224,31,3,14,0,12,16,1254,1188,29,2,14,0,6,15,46,36,2,1,0,0,6,1
250173641013,1964,1837,26,1,62,0,12,26,1907,1796,23,1,62,0,2,23,57,41,3,0,0,0,10,3
250173641021,1312,1180,24,3,65,0,23,17,1246,1140,24,3,64,0,7,8,66,40,0,0,1,0,16,9
250173641022,1314,1239,18,0,19,0,23,15,1289,1220,17,0,19,0,18,15,25,19,1,0,0,0,5,0
250173641023,944,901,13,0,7,0,6,17,914,876,13,0,7,0,3,15,30,25,0,0,0,0,3,2
250173641024,1270,1165,14,0,61,0,6,24,1254,1156,12,0,61,0,3,22,16,9,2,0,0,0,3,2
250173651001,1619,1448,10,0,119,0,8,34,1589,1423,10,0,118,0,8,30,30,25,0,0,1,0,0,4
250173651002,2266,2054,15,1,139,2,5,50,2239,2029,15,1,139,2,3,50,27,25,0,0,0,0,2,0
250173651003,2331,2096,21,1,170,0,5,38,2296,2073,21,1,170,0,1,30,35,23,0,0,0,0,4,8
250173651004,1516,1415,16,0,48,0,16,21,1480,1386,14,0,48,0,12,20,36,29,2,0,0,0,4,1
250173652011,1921,1774,13,3,87,1,6,37,1886,1749,11,1,87,1,3,34,35,25,2,2,0,0,3,3
250173652012,1275,1152,3,0,84,2,8,26,1255,1139,1,0,84,2,4,25,20,13,2,0,0,0,4,1
250173652013,1086,958,7,0,86,0,15,20,1044,927,7,0,86,0,8,16,42,31,0,0,0,0,7,4
250173652014,1325,1226,6,0,66,3,2,22,1303,1208,6,0,66,0,2,21,22,18,0,0,0,3,0,1
250173652021,1779,1598,37,3,85,1,24,31,1727,1570,31,2,85,1,10,28,52,28,6,1,0,0,14,3
250173652022,1204,1087,11,0,85,0,2,19,1189,1074,11,0,85,0,1,18,15,13,0,0,0,0,1,1
250173652023,1337,1228,10,1,72,0,8,18,1301,1201,10,1,72,0,0,17,36,27,0,0,0,0,8,1
250214222006,1545,1414,22,2,20,4,50,33,1508,1394,20,2,20,4,40,28,37,20,2,0,0,0,10,5
250214223011,1226,1145,19,2,20,0,18,22,1202,1138,18,2,20,0,8,16,24,7,1,0,0,0,10,6
250214223012,1749,1661,19,2,23,0,17,27,1727,1643,19,2,23,0,15,25,22,18,0,0,0,0,2,2
250214223021,1290,1242,3,1,12,2,22,8,1271,1228,3,1,12,2,18,7,19,14,0,0,0,0,4,1
250214223022,936,773,47,4,72,0,24,16,909,755,47,0,72,0,20,15,27,18,0,4,0,0,4,1
250214223023,1763,1175,270,8,157,0,93,60,1686,1143,263,8,155,0,62,55,77,32,7,0,2,0,31,5
250214223024,1720,1561,40,4,59,2,13,41,1663,1522,29,4,59,2,9,38,57,39,11,0,0,0,4,3
250214223025,881,822,23,1,14,0,14,7,855,810,18,1,14,0,8,4,26,12,5,0,0,0,6,3
250214224001,1006,950,24,1,18,0,4,9,988,936,23,1,18,0,3,7,18,14,1,0,0,0,1,2
250214224002,1276,1110,76,2,13,0,50,25,1220,1070,70,2,13,0,42,23,56,40,6,0,0,0,8,2
250214224003,1834,1693,15,1,78,0,15,32,1807,1674,12,1,78,0,10,32,27,19,3,0,0,0,5,0
250214224004,709,663,8,1,27,0,4,6,706,660,8,1,27,0,4,6,3,3,0,0,0,0,0,0
250214224005,2960,2447,176,6,145,0,80,106,2872,2399,170,6,145,0,62,90,88,48,6,0,0,0,18,16
250214225011,1207,998,86,2,50,0,40,31,1169,983,79,2,50,0,29,26,38,15,7,0,0,0,11,5
250214225012,2105,1606,256,11,71,1,87,73,1993,1564,233,11,71,0,50,64,112,42,23,0,0,1,37,9
250214225013,698,662,3,0,21,0,7,5,687,655,3,0,21,0,4,4,11,7,0,0,0,0,3,1
250214225014,748,720,13,1,6,0,3,5,740,714,12,1,6,0,2,5,8,6,1,0,0,0,1,0
250214225021,1078,868,40,4,19,1,121,25,1036,845,39,3,19,1,105,24,42,23,1,1,0,0,16,1
250214225022,1145,1014,37,2,26,1,42,23,1106,994,36,2,26,1,28,19,39,20,1,0,0,0,14,4
250214225023,1722,1547,42,4,64,1,31,33,1666,1503,42,4,64,0,26,27,56,44,0,0,0,1,5,6
250214225024,1220,969,118,12,28,0,38,55,1151,936,100,12,28,0,24,51,69,33,18,0,0,0,14,4
250214226001,917,868,3,0,30,0,12,4,886,843,3,0,30,0,6,4,31,25,0,0,0,0,6,0
250214226002,895,824,14,0,16,0,25,16,863,806,14,0,16,0,11,16,32,18,0,0,0,0,14,0
250214226003,1324,1266,2,2,18,0,7,29,1297,1243,2,2,18,0,4,28,27,23,0,0,0,0,3,1
250214226004,1104,1061,3,0,27,0,6,7,1080,1040,2,0,27,0,4,7,24,21,1,0,0,0,2,0
250214226005,967,929,9,0,17,0,6,6,948,918,6,0,17,0,1,6,19,11,3,0,0,0,5,0
250214226006,593,540,6,0,37,0,2,8,589,538,6,0,37,0,0,8,4,2,0,0,0,0,2,0
250214226007,868,810,5,1,32,0,9,11,852,798,5,1,32,0,5,11,16,12,0,0,0,0,4,0
250214227001,1507,1445,14,6,26,0,0,16,1473,1413,14,5,26,0,0,15,34,32,0,1,0,0,0,1
250214227002,931,872,3,0,33,0,8,15,898,844,2,0,33,0,6,13,33,28,1,0,0,0,2,2
250214227003,790,719,9,1,25,0,14,22,760,705,2,1,25,0,12,15,30,14,7,0,0,0,2,7
250214227004,614,551,7,0,38,0,5,13,600,538,7,0,38,0,4,13,14,13,0,0,0,0,1,0
250214228001,1451,1378,24,0,31,0,6,12,1426,1358,21,0,31,0,5,11,25,20,3,0,0,0,1,1
250214228002,888,860,4,3,12,0,3,6,865,841,4,1,12,0,3,4,23,19,0,2,0,0,0,2
250214228003,769,702,16,1,20,0,15,15,747,685,16,1,20,0,12,13,22,17,0,0,0,0,3,2
250214228004,744,702,8,2,11,0,18,3,717,685,6,2,11,0,10,3,27,17,2,0,0,0,8,0
250214231001,1313,1283,3,4,9,0,4,10,1295,1266,2,4,9,0,4,10,18,17,1,0,0,0,0,0
250214231002,1462,1411,5,1,21,0,2,22,1436,1390,5,0,18,0,2,21,26,21,0,1,3,0,0,1
250214231003,672,661,0,3,1,0,1,6,661,654,0,1,1,0,0,5,11,7,0,2,0,0,1,1
250214231004,1806,1756,0,1,23,0,1,25,1794,1747,0,1,22,0,0,24,12,9,0,0,1,0,1,1
250214231005,1039,1012,5,1,6,1,5,9,1033,1006,5,1,6,1,5,9,6,6,0,0,0,0,0,0
250214231006,1250,1214,8,1,15,0,0,12,1227,1191,8,1,15,0,0,12,23,23,0,0,0,0,0,0
250214401001,1004,941,12,6,34,0,4,7,979,922,12,4,34,0,1,6,25,19,0,2,0,0,3,1
250214401002,2287,2176,31,1,56,0,2,21,2261,2159,27,1,55,0,0,19,26,17,4,0,1,0,2,2
250214401003,1219,1174,4,0,14,0,7,20,1190,1155,4,0,14,0,0,17,29,19,0,0,0,0,7,3
250214401004,1870,1789,12,1,50,0,2,16,1855,1775,12,1,50,0,1,16,15,14,0,0,0,0,1,0
250214401005,1884,1705,29,4,104,0,19,23,1832,1680,25,3,104,0,4,16,52,25,4,1,0,0,15,7
250214412021,2726,2640,14,8,43,0,0,21,2683,2602,14,6,43,0,0,18,43,38,0,2,0,0,0,3
250214412031,2552,2456,10,8,35,0,6,37,2522,2438,10,7,35,0,2,30,30,18,0,1,0,0,4,7
250214412032,1178,1163,6,0,2,0,1,6,1169,1154,6,0,2,0,1,6,9,9,0,0,0,0,0,0
250214412041,2101,2059,23,0,7,0,3,9,2083,2047,22,0,7,0,0,7,18,12,1,0,0,0,3,2
250214412042,2398,2316,8,3,25,0,13,33,2365,2300,8,3,25,0,3,26,33,16,0,0,0,0,10,7
250214421011,972,929,14,1,13,0,6,9,962,923,14,1,13,0,2,9,10,6,0,0,0,0,4,0
250214421012,2114,1998,19,2,76,0,1,18,2091,1977,19,1,76,0,0,18,23,21,0,1,0,0,1,0
250214421013,1524,1312,111,4,54,0,19,24,1460,1274,98,4,54,0,6,24,64,38,13,0,0,0,13,0
250214421014,962,896,18,1,29,0,8,10,937,878,18,0,29,0,5,7,25,18,0,1,0,0,3,3
250214421021,1772,1659,21,0,53,1,12,26,1743,1634,20,0,53,1,9,26,29,25,1,0,0,0,3,0
250214421022,1510,1405,15,1,62,0,9,18,1485,1388,15,1,62,0,3,16,25,17,0,0,0,0,6,2
250214421023,2663,2513,16,1,109,1,5,18,2614,2467,16,1,109,0,3,18,49,46,0,0,0,1,2,0
250214421024,1126,1074,7,0,35,0,0,10,1119,1068,7,0,35,0,0,9,7,6,0,0,0,0,0,1
250214421031,2999,2844,18,2,93,1,4,37,2959,2809,18,1,93,1,1,36,40,35,0,1,0,0,3,1
250214421032,2557,2390,20,4,100,0,9,34,2502,2352,16,3,100,0,1,30,55,38,4,1,0,0,8,4
250214421033,1390,1189,11,1,156,0,2,31,1370,1170,11,1,156,0,2,30,20,19,0,0,0,0,0,1
250214422011,1742,1569,35,0,102,1,8,27,1702,1540,31,0,102,1,3,25,40,29,4,0,0,0,5,2
250214422012,2424,2286,34,0,61,0,4,39,2390,2257,34,0,60,0,3,36,34,29,0,0,1,0,1,3
250214422021,3101,2836,62,9,105,0,30,59,3016,2800,56,7,105,0,1,47,85,36,6,2,0,0,29,12
250214422022,1467,1345,30,2,47,0,6,37,1434,1324,25,2,47,0,2,34,33,21,5,0,0,0,4,3
250214422023,1193,1100,8,7,38,0,21,19,1142,1076,8,1,38,0,4,15,51,24,0,6,0,0,17,4
250214422024,2119,2005,10,10,61,1,3,29,2089,1989,10,0,61,1,1,27,30,16,0,10,0,0,2,2
250214431011,1767,1663,24,1,26,0,24,29,1733,1648,24,1,26,0,8,26,34,15,0,0,0,0,16,3
250214431012,2076,1913,30,1,58,1,38,35,1973,1852,28,1,58,1,9,24,103,61,2,0,0,0,29,11
250214431013,1774,1656,24,3,64,0,9,18,1721,1611,24,1,63,0,5,17,53,45,0,2,1,0,4,1
250214431014,2021,1911,20,3,56,1,13,17,1976,1877,19,2,56,1,6,15,45,34,1,1,0,0,7,2
250214431021,1979,1861,37,0,48,0,5,28,1954,1842,37,0,48,0,0,27,25,19,0,0,0,0,5,1
250214431022,2866,2576,49,1,185,0,21,34,2808,2543,42,1,185,0,4,33,58,33,7,0,0,0,17,1
250214431023,1486,1421,24,4,11,1,3,22,1461,1403,21,4,11,0,1,21,25,18,3,0,0,1,2,1
250214431024,1360,1313,7,0,11,1,11,17,1335,1297,7,0,11,1,4,15,25,16,0,0,0,0,7,2
250214431025,1003,925,20,0,17,0,19,22,962,912,15,0,15,0,1,19,41,13,5,0,2,0,18,3
250214561011,2086,1647,258,4,86,0,51,40,2023,1608,248,4,86,0,44,33,63,39,10,0,0,0,7,7
250214561012,1690,1355,193,2,71,0,26,43,1656,1335,193,1,71,0,14,42,34,20,0,1,0,0,12,1
250214561021,1679,1307,188,1,52,0,59,72,1603,1258,186,1,52,0,42,64,76,49,2,0,0,0,17,8
250214561022,2207,1730,254,4,117,0,40,62,2148,1691,242,2,117,0,36,60,59,39,12,2,0,0,4,2
250214561023,1059,827,145,3,25,0,28,31,1022,806,141,3,25,0,18,29,37,21,4,0,0,0,10,2
250214562001,1126,771,188,5,89,0,18,55,1079,754,180,4,89,0,15,37,47,17,8,1,0,0,3,18
250214562002,2020,1670,204,1,75,0,22,48,1992,1654,193,1,75,0,22,47,28,16,11,0,0,0,0,1
250214563011,952,643,130,6,30,0,85,58,897,635,122,1,30,0,61,48,55,8,8,5,0,0,24,10
250214563012,801,601,122,5,20,0,27,26,768,586,116,5,20,0,19,22,33,15,6,0,0,0,8,4
250214563021,2004,1664,225,3,58,1,22,31,1929,1614,217,3,57,1,13,24,75,50,8,0,1,0,9,7
250214563022,1153,965,111,3,32,0,19,23,1134,956,108,3,32,0,17,18,19,9,3,0,0,0,2,5
250214563023,813,724,40,3,16,0,25,5,791,716,39,3,16,0,14,3,22,8,1,0,0,0,11,2
250214563024,1030,750,192,1,38,0,29,20,979,718,185,0,38,0,21,17,51,32,7,1,0,0,8,3
250214564011,1073,834,119,1,36,0,51,32,1029,825,104,1,36,0,32,31,44,9,15,0,0,0,19,1
250214564012,1692,1421,139,1,49,0,24,58,1645,1388,138,1,49,0,14,55,47,33,1,0,0,0,10,3
250214564021,981,839,93,0,14,0,11,24,945,814,93,0,14,0,5,19,36,25,0,0,0,0,6,5
250214564022,1331,1104,127,0,60,0,19,21,1304,1088,125,0,60,0,12,19,27,16,2,0,0,0,7,2
250214564023,2387,2021,188,3,89,1,52,33,2310,1970,184,2,89,1,32,32,77,51,4,1,0,0,20,1
250214564024,878,761,68,0,14,0,22,13,832,724,64,0,14,0,17,13,46,37,4,0,0,0,5,0
250214571001,967,833,77,4,23,0,17,13,943,824,77,0,23,0,6,13,24,9,0,4,0,0,11,0
250214571002,1136,977,101,0,37,0,11,10,1108,964,93,0,37,0,6,8,28,13,8,0,0,0,5,2
250214571003,1137,938,127,1,20,0,22,29,1095,924,119,1,20,0,15,16,42,14,8,0,0,0,7,13
250214571004,1116,912,129,0,40,0,15,20,1089,903,125,0,40,0,3,18,27,9,4,0,0,0,12,2
250214572001,1021,958,4,0,37,0,6,16,1005,948,4,0,37,0,2,14,16,10,0,0,0,0,4,2
250214572002,945,916,8,0,10,0,1,10,936,908,8,0,10,0,1,9,9,8,0,0,0,0,0,1
250214572003,1595,1373,22,0,156,0,12,32,1556,1345,22,0,156,0,5,28,39,28,0,0,0,0,7,4
250214572004,1382,1263,2,2,85,0,12,18,1358,1243,2,1,85,0,10,17,24,20,0,1,0,0,2,1
250214572005,708,653,0,0,47,0,2,6,701,646,0,0,47,0,2,6,7,7,0,0,0,0,0,0
250235001011,1502,1450,18,5,6,0,1,22,1480,1433,17,5,6,0,0,19,22,17,1,0,0,0,1,3
250235001012,819,780,2,3,6,0,13,15,807,776,2,3,6,0,8,12,12,4,0,0,0,0,5,3
250235001013,1381,1292,31,1,12,1,14,30,1363,1283,31,0,11,1,11,26,18,9,0,1,1,0,3,4
250235001031,2209,2131,18,6,19,0,4,31,2184,2110,18,5,19,0,3,29,25,21,0,1,0,0,1,2
250235001041,1207,1145,7,6,22,0,12,15,1183,1131,3,3,22,0,9,15,24,14,4,3,0,0,3,0
250235001042,919,881,1,7,7,4,3,16,906,872,1,7,7,4,2,13,13,9,0,0,0,0,1,3
250235001043,792,742,7,10,2,0,12,19,768,731,6,6,2,0,8,15,24,11,1,4,0,0,4,4
250235001044,1464,1381,10,14,28,0,9,22,1429,1366,10,5,27,0,2,19,35,15,0,9,1,0,7,3
250235011011,1218,1176,2,1,16,5,5,13,1206,1165,2,1,16,5,5,12,12,11,0,0,0,0,0,1
250235011012,1317,1276,2,1,27,0,1,10,1311,1271,2,1,27,0,0,10,6,5,0,0,0,0,1,0
250235011013,767,738,2,1,10,0,4,12,759,734,2,1,10,0,4,8,8,4,0,0,0,0,0,4
250235011021,1040,1014,1,1,7,0,4,13,1029,1010,1,1,7,0,1,9,11,4,0,0,0,0,3,4
250235011022,2378,2262,20,5,45,2,4,40,2354,2238,20,5,45,2,4,40,24,24,0,0,0,0,0,0
250235011023,1974,1900,10,5,24,0,6,29,1947,1879,6,4,24,0,6,28,27,21,4,1,0,0,0,1
250235011024,2665,2552,25,1,41,0,8,38,2627,2522,25,1,41,0,2,36,38,30,0,0,0,0,6,2
250235012011,1262,1214,3,5,14,1,0,25,1253,1207,1,5,14,1,0,25,9,7,2,0,0,0,0,0
250235012012,2405,2328,15,5,30,0,4,23,2381,2306,15,5,30,0,4,21,24,22,0,0,0,0,0,2
250235012021,1032,991,0,1,17,0,3,20,1020,982,0,1,17,0,0,20,12,9,0,0,0,0,3,0
250235012022,1591,1523,8,5,29,0,10,16,1566,1508,8,3,29,0,3,15,25,15,0,2,0,0,7,1
250235012023,4508,4351,30,3,83,0,9,32,4463,4313,27,3,83,0,7,30,45,38,3,0,0,0,2,2
250235021011,1689,1593,24,5,24,1,27,15,1664,1577,23,5,24,1,20,14,25,16,1,0,0,0,7,1
250235021012,1501,1306,35,1,5,0,110,44,1466,1284,31,1,5,0,106,39,35,22,4,0,0,0,4,5
250235021013,1361,1275,42,0,5,0,20,19,1343,1262,37,0,5,0,20,19,18,13,5,0,0,0,0,0
250235021014,1500,1309,63,3,25,0,53,47,1477,1295,63,3,25,0,47,44,23,14,0,0,0,0,6,3
250235021021,1713,1601,36,8,21,3,21,23,1683,1585,34,3,21,3,14,23,30,16,2,5,0,0,7,0
250235021022,1905,1797,30,0,29,1,19,29,1871,1774,30,0,29,1,11,26,34,23,0,0,0,0,8,3
250235021023,1982,1683,125,0,20,0,65,89,1885,1629,120,0,20,0,44,72,97,54,5,0,0,0,21,17
250235022001,1252,1184,32,1,6,0,21,8,1221,1167,30,1,6,0,12,5,31,17,2,0,0,0,9,3
250235022002,1501,1426,28,6,3,0,12,26,1468,1397,26,6,3,0,12,24,33,29,2,0,0,0,0,2
250235022003,2054,1936,34,3,27,0,21,33,2038,1929,34,3,27,0,14,31,16,7,0,0,0,0,7,2
250235022004,1031,985,3,0,27,0,9,7,1025,980,3,0,27,0,8,7,6,5,0,0,0,0,1,0
250235031011,2030,1940,31,2,22,1,8,26,2005,1917,31,1,22,1,7,26,25,23,0,1,0,0,1,0
250235031012,3424,3306,29,1,43,0,22,23,3381,3280,25,1,43,0,15,17,43,26,4,0,0,0,7,6
250235031013,1722,1657,15,4,10,0,8,28,1705,1646,15,4,10,0,3,27,17,11,0,0,0,0,5,1
250235031021,1227,1196,2,4,10,1,5,9,1225,1196,2,4,10,1,4,8,2,0,0,0,0,0,1,1
250235031022,1555,1489,4,2,27,1,13,19,1546,1481,4,2,27,0,13,19,9,8,0,0,0,1,0,0
250235031023,839,805,0,0,31,0,3,0,834,803,0,0,31,0,0,0,5,2,0,0,0,0,3,0
250235031024,936,919,5,0,2,0,2,8,928,912,5,0,2,0,1,8,8,7,0,0,0,0,1,0
250235031025,1111,1092,1,2,5,0,3,8,1105,1087,1,1,5,0,3,8,6,5,0,1,0,0,0,0
250235031026,1035,988,23,0,11,2,3,8,1022,978,23,0,10,2,1,8,13,10,0,0,1,0,2,0
250235041011,2416,2330,14,0,44,0,4,24,2375,2292,14,0,44,0,3,22,41,38,0,0,0,0,1,2
250235041012,1658,1598,17,1,21,0,3,18,1636,1578,17,1,21,0,1,18,22,20,0,0,0,0,2,0
250235041013,1296,1250,11,1,26,0,0,8,1276,1233,11,1,26,0,0,5,20,17,0,0,0,0,0,3
250235041021,1528,1453,2,1,42,0,7,23,1521,1448,2,1,42,0,5,23,7,5,0,0,0,0,2,0
250235041022,965,947,0,0,8,0,0,10,961,945,0,0,8,0,0,8,4,2,0,0,0,0,0,2
250235041023,1552,1486,13,2,30,0,6,15,1531,1470,13,2,30,0,3,13,21,16,0,0,0,0,3,2
250235041024,1091,1050,7,3,10,0,12,9,1078,1045,6,3,10,0,7,7,13,5,1,0,0,0,5,2
250235051011,1338,1303,0,5,11,0,11,8,1328,1294,0,5,11,0,10,8,10,9,0,0,0,0,1,0
250235051012,1175,1120,13,1,12,0,4,25,1159,1112,9,1,12,0,4,21,16,8,4,0,0,0,0,4
250235051013,1143,1107,1,0,4,0,17,14,1127,1091,1,0,4,0,17,14,16,16,0,0,0,0,0,0
250235051014,1092,991,0,2,10,3,66,20,1082,986,0,1,10,3,65,17,10,5,0,1,0,0,1,3
250235051015,1720,1640,21,0,12,0,20,27,1700,1627,21,0,10,0,20,22,20,13,0,0,2,0,0,5
250235051021,1208,1191,2,0,2,0,5,8,1197,1180,2,0,2,0,5,8,11,11,0,0,0,0,0,0
250235051022,1551,1506,9,2,17,1,5,11,1535,1493,8,2,17,1,3,11,16,13,1,0,0,0,2,0
250235051023,1380,1317,5,0,11,2,0,45,1362,1303,5,0,11,2,0,41,18,14,0,0,0,0,0,4
250235051024,852,826,8,1,3,0,2,12,847,821,8,1,3,0,2,12,5,5,0,0,0,0,0,0
250235052001,477,467,1,0,2,0,2,5,473,463,1,0,2,0,2,5,4,4,0,0,0,0,0,0
250235052002,2016,1914,23,1,26,0,22,30,1992,1892,23,1,26,0,20,30,24,22,0,0,0,0,2,0
250235052003,2939,2823,20,2,19,0,51,24,2904,2798,19,2,19,0,43,23,35,25,1,0,0,0,8,1
250235052004,1242,1220,1,0,7,1,8,5,1236,1217,1,0,5,1,7,5,6,3,0,0,2,0,1,0
250235061011,1459,1415,9,2,15,0,1,17,1454,1411,9,1,15,0,1,17,5,4,0,1,0,0,0,0
250235061012,2480,2385,10,6,24,2,14,39,2434,2358,8,6,24,2,3,33,46,27,2,0,0,0,11,6
250235061013,1055,1027,3,2,11,0,3,9,1042,1018,3,2,11,0,0,8,13,9,0,0,0,0,3,1
250235061014,1537,1498,5,0,14,0,5,15,1518,1482,5,0,14,0,5,12,19,16,0,0,0,0,0,3
250235061021,897,859,9,3,11,0,3,12,889,852,9,3,11,0,3,11,8,7,0,0,0,0,0,1
250235061022,1256,1223,6,0,7,0,9,11,1248,1216,6,0,7,0,8,11,8,7,0,0,0,0,1,0
250235061023,1448,1405,7,2,9,0,14,11,1426,1393,7,2,9,0,6,9,22,12,0,0,0,0,8,2
250235061024,1638,1491,18,3,22,0,67,37,1579,1466,18,3,22,0,45,25,59,25,0,0,0,0,22,12
250235061025,660,639,8,0,9,0,0,4,654,633,8,0,9,0,0,4,6,6,0,0,0,0,0,0
250235062021,1181,1155,5,3,3,0,6,9,1174,1151,5,3,3,0,3,9,7,4,0,0,0,0,3,0
250235062022,1331,1303,1,0,8,1,7,11,1316,1293,1,0,8,1,5,8,15,10,0,0,0,0,2,3
250235062031,2036,1953,8,5,15,0,31,24,2016,1936,8,4,15,0,29,24,20,17,0,1,0,0,2,0
250235062032,1385,1364,2,0,4,0,3,12,1373,1354,2,0,4,0,2,11,12,10,0,0,0,0,1,1
250235062033,1799,1767,1,8,4,0,7,12,1772,1742,1,8,4,0,6,11,27,25,0,0,0,0,1,1
250235062041,1971,1925,11,1,6,1,8,19,1950,1909,11,1,6,1,5,17,21,16,0,0,0,0,3,2
250235062042,1786,1750,3,1,4,0,12,16,1764,1741,3,0,4,0,1,15,22,9,0,1,0,0,11,1
250235062043,1213,1177,6,2,12,0,9,7,1208,1172,6,2,12,0,9,7,5,5,0,0,0,0,0,0
250235071011,2284,2241,11,2,18,0,1,11,2254,2212,11,2,18,0,0,11,30,29,0,0,0,0,1,0
250235071012,1392,1359,3,2,10,0,5,13,1378,1348,2,2,10,0,3,13,14,11,1,0,0,0,2,0
250235071013,1647,1573,20,1,23,0,11,19,1622,1555,20,1,23,0,7,16,25,18,0,0,0,0,4,3
250235071031,1241,1209,5,0,12,0,1,14,1221,1192,4,0,12,0,0,13,20,17,1,0,0,0,1,1
250235071032,1121,1087,0,3,8,0,2,21,1105,1074,0,3,8,0,2,18,16,13,0,0,0,0,0,3
250235071033,991,981,1,0,3,0,2,4,979,969,1,0,3,0,2,4,12,12,0,0,0,0,0,0
250235071034,998,978,0,1,7,0,7,5,981,966,0,1,7,0,2,5,17,12,0,0,0,0,5,0
250235071041,2284,2204,7,5,37,1,15,15,2261,2187,7,5,36,1,11,14,23,17,0,0,1,0,4,1
250235071042,2111,2046,11,1,21,0,14,18,2089,2030,10,1,21,0,10,17,22,16,1,0,0,0,4,1
250235071043,990,971,4,1,10,1,0,3,985,966,4,1,10,1,0,3,5,5,0,0,0,0,0,0
250235081011,1729,1686,10,0,12,0,7,14,1707,1666,10,0,12,0,5,14,22,20,0,0,0,0,2,0
250235081012,954,925,0,0,29,0,0,0,943,914,0,0,29,0,0,0,11,11,0,0,0,0,0,0
250235081013,830,785,12,3,11,0,0,19,821,779,12,2,11,0,0,17,9,6,0,1,0,0,0,2
250235081014,2124,2027,11,2,25,0,22,37,2097,2013,8,2,25,0,12,37,27,14,3,0,0,0,10,0
250235081015,1071,1043,1,3,23,0,0,1,1067,1039,1,3,23,0,0,1,4,4,0,0,0,0,0,0
250235081021,1921,1872,4,4,16,1,11,13,1899,1861,3,4,15,1,5,10,22,11,1,0,1,0,6,3
250235081022,2058,1983,10,11,7,0,17,30,2027,1963,10,8,7,0,11,28,31,20,0,3,0,0,6,2
250235081023,1119,1088,17,1,3,0,1,9,1116,1086,17,1,3,0,0,9,3,2,0,0,0,0,1,0
250235082001,1381,1317,17,0,17,1,13,16,1364,1304,17,0,17,1,9,16,17,13,0,0,0,0,4,0
250235082002,2705,2636,18,4,23,1,7,16,2673,2615,18,3,21,1,1,14,32,21,0,1,2,0,6,2
250235082003,1945,1912,9,1,4,0,1,18,1930,1898,9,1,4,0,0,18,15,14,0,0,0,0,1,0
250235091011,2349,2252,27,1,33,0,4,32,2313,2219,26,1,33,0,3,31,36,33,1,0,0,0,1,1
250235091012,1776,1707,13,2,23,1,8,22,1761,1698,13,2,23,1,5,19,15,9,0,0,0,0,3,3
250235091013,1518,1479,8,0,11,0,5,15,1501,1463,8,0,11,0,4,15,17,16,0,0,0,0,1,0
250235091014,1304,1223,30,4,5,0,13,29,1287,1217,29,2,5,0,13,21,17,6,1,2,0,0,0,8
250235091021,1640,1598,17,0,6,0,5,14,1628,1589,16,0,6,0,3,14,12,9,1,0,0,0,2,0
250235091022,975,942,7,0,7,0,7,12,963,933,7,0,7,0,5,11,12,9,0,0,0,0,2,1
250235091023,695,674,1,1,16,0,1,2,689,668,1,1,16,0,1,2,6,6,0,0,0,0,0,0
250235091024,1632,1547,23,6,12,0,17,27,1615,1534,22,6,12,0,16,25,17,13,1,0,0,0,1,2
250235091025,740,715,7,0,3,0,6,9,732,710,7,0,3,0,3,9,8,5,0,0,0,0,3,0
250235101001,1460,1102,232,6,22,0,41,57,1384,1064,230,5,22,0,13,50,76,38,2,1,0,0,28,7
250235101002,1172,889,201,3,8,0,24,47,1106,844,195,2,8,0,18,39,66,45,6,1,0,0,6,8
250235101003,792,565,160,5,9,0,31,22,728,527,150,5,9,0,18,19,64,38,10,0,0,0,13,3
250235101004,1352,727,381,16,51,0,93,84,1236,692,372,15,51,0,41,65,116,35,9,1,0,0,52,19
250235102001,1706,1138,348,8,69,1,86,56,1601,1091,342,7,68,1,43,49,105,47,6,1,1,0,43,7
250235102002,1213,780,315,3,11,0,41,63,1152,758,299,3,11,0,26,55,61,22,16,0,0,0,15,8
250235102003,682,255,203,0,28,0,129,67,585,223,192,0,28,0,84,58,97,32,11,0,0,0,45,9
250235102004,2363,1127,709,12,60,0,321,134,2139,1036,683,12,60,0,245,103,224,91,26,0,0,0,76,31
250235103001,1636,468,632,3,39,5,233,256,1439,411,602,2,39,4,151,230,197,57,30,1,0,1,82,26
250235103002,550,139,201,0,0,0,148,62,443,91,196,0,0,0,111,45,107,48,5,0,0,0,37,17
250235103003,1612,398,700,7,72,0,283,152,1461,370,653,4,72,0,227,135,151,28,47,3,0,0,56,17
250235104001,880,247,389,6,9,4,173,52,739,167,374,4,9,0,138,47,141,80,15,2,0,4,35,5
250235104002,721,210,242,6,23,0,177,63,595,159,229,4,23,0,125,55,126,51,13,2,0,0,52,8
250235104003,1269,204,536,4,9,0,384,132,1080,148,502,2,9,0,320,99,189,56,34,2,0,0,64,33
250235104004,836,268,321,4,20,0,165,58,719,227,312,4,20,0,99,57,117,41,9,0,0,0,66,1
250235105011,683,331,282,0,16,0,27,27,617,311,262,0,16,0,3,25,66,20,20,0,0,0,24,2
250235105012,2675,1383,805,11,60,0,193,223,2504,1307,772,9,60,0,153,203,171,76,33,2,0,0,40,20
250235105021,1022,322,446,2,26,0,149,77,883,272,413,2,26,0,103,67,139,50,33,0,0,0,46,10
250235105022,1311,675,392,2,64,1,102,75,1222,636,383,2,64,0,68,69,89,39,9,0,0,1,34,6
250235105023,1279,473,589,7,32,2,87,89,1163,423,571,3,32,1,50,83,116,50,18,4,0,1,37,6
250235105024,525,281,169,0,15,0,35,25,490,267,164,0,15,0,24,20,35,14,5,0,0,0,11,5
250235105025,1659,831,557,11,35,1,137,87,1517,774,544,7,35,1,83,73,142,57,13,4,0,0,54,14
250235105031,1930,543,905,5,53,0,203,221,1736,447,878,3,53,0,154,201,194,96,27,2,0,0,49,20
250235105032,1011,550,337,2,29,1,66,26,956,531,320,2,29,1,52,21,55,19,17,0,0,0,14,5
250235105033,1355,1079,182,0,28,0,45,21,1314,1057,182,0,28,0,27,20,41,22,0,0,0,0,18,1
250235106001,784,588,106,0,27,0,31,32,747,572,104,0,27,0,18,26,37,16,2,0,0,0,13,6
250235106002,1039,836,134,1,28,0,22,18,987,808,122,1,28,0,15,13,52,28,12,0,0,0,7,5
250235106003,1034,726,177,2,54,0,39,36,992,707,166,1,54,0,28,36,42,19,11,1,0,0,11,0
250235107001,1415,527,575,2,103,1,120,87,1292,471,559,1,103,1,80,77,123,56,16,1,0,0,40,10
250235107002,570,320,154,2,8,0,55,31,512,302,142,2,8,0,31,27,58,18,12,0,0,0,24,4
250235107003,721,443,174,2,16,0,51,35,681,420,169,1,16,0,46,29,40,23,5,1,0,0,5,6
250235107004,1061,498,385,2,28,0,96,52,984,467,370,2,28,0,71,46,77,31,15,0,0,0,25,6
250235107005,724,370,247,4,27,0,48,28,664,339,231,4,27,0,38,25,60,31,16,0,0,0,10,3
250235107006,1165,629,295,1,24,1,120,95,1093,616,276,1,24,1,94,81,72,13,19,0,0,0,26,14
250235108001,898,187,350,1,12,1,280,67,754,134,335,1,12,0,222,50,144,53,15,0,0,1,58,17
250235108002,894,180,427,0,10,0,199,78,799,158,418,0,10,0,146,67,95,22,9,0,0,0,53,11
250235108003,887,198,394,5,15,2,201,72,753,160,368,5,15,2,139,64,134,38,26,0,0,0,62,8
250235108004,1455,289,764,4,30,0,236,132,1277,236,731,3,30,0,167,110,178,53,33,1,0,0,69,22
250235108005,749,200,362,2,20,0,110,55,678,185,349,1,18,0,85,40,71,15,13,1,2,0,25,15
250235108006,1456,354,626,12,41,6,265,152,1251,297,580,6,41,6,195,126,205,57,46,6,0,0,70,26
250235109001,378,187,116,1,5,0,36,33,324,156,113,1,5,0,22,27,54,31,3,0,0,0,14,6
250235109002,1052,240,420,5,6,0,251,130,873,190,383,2,4,0,192,102,179,50,37,3,2,0,59,28
250235109003,1101,318,445,13,12,3,213,97,928,256,420,11,12,2,153,74,173,62,25,2,0,1,60,23
250235110001,568,192,238,8,5,3,65,57,516,178,236,8,5,3,40,46,52,14,2,0,0,0,25,11
250235110002,2472,836,823,15,24,2,535,237,2059,684,761,8,22,2,399,183,413,152,62,7,2,0,136,54
250235111001,997,653,260,3,26,0,33,22,951,628,253,3,26,0,24,17,46,25,7,0,0,0,9,5
250235111002,627,361,153,2,4,0,73,34,570,351,152,2,4,0,37,24,57,10,1,0,0,0,36,10
250235111003,1631,1108,361,5,42,0,60,55,1536,1066,346,5,42,0,40,37,95,42,15,0,0,0,20,18
250235111004,637,420,153,4,3,0,32,25,587,401,148,4,3,0,10,21,50,19,5,0,0,0,22,4
250235111005,610,417,124,0,10,0,28,31,574,397,124,0,10,0,18,25,36,20,0,0,0,0,10,6
250235111006,789,346,282,2,30,0,65,64,693,290,272,2,28,0,40,61,96,56,10,0,2,0,25,3
250235112001,966,620,217,4,20,0,56,49,910,602,213,3,20,0,27,45,56,18,4,1,0,0,29,4
250235112002,1220,621,378,3,4,0,141,73,1038,540,353,3,4,0,82,56,182,81,25,0,0,0,59,17
250235112003,1344,495,444,1,18,0,296,90,1111,422,410,1,18,0,189,71,233,73,34,0,0,0,107,19
250235112004,608,342,152,1,4,0,74,35,567,328,149,1,4,0,63,22,41,14,3,0,0,0,11,13
250235112005,711,430,162,0,13,0,60,46,669,411,155,0,13,0,46,44,42,19,7,0,0,0,14,2
250235113011,1178,377,412,4,12,0,211,162,966,281,389,2,12,0,146,136,212,96,23,2,0,0,65,26
250235113012,690,309,219,9,30,0,98,25,626,278,215,9,30,0,71,23,64,31,4,0,0,0,27,2
250235113013,1115,512,375,1,3,0,142,82,980,469,362,0,3,0,77,69,135,43,13,1,0,0,65,13
250235113014,1487,629,488,2,15,6,205,142,1320,571,459,0,15,0,147,128,167,58,29,2,0,6,58,14
250235113015,864,472,220,5,32,0,72,63,833,467,218,5,32,0,53,58,31,5,2,0,0,0,19,5
250235113021,656,461,151,4,0,0,15,25,611,435,140,4,0,0,13,19,45,26,11,0,0,0,2,6
250235113022,737,458,189,1,4,0,49,36,677,441,182,1,4,0,20,29,60,17,7,0,0,0,29,7
250235113023,1267,704,416,4,13,0,74,56,1186,667,407,4,13,0,51,44,81,37,9,0,0,0,23,12
250235113024,871,317,301,8,8,0,164,73,695,246,276,0,8,0,108,57,176,71,25,8,0,0,56,16
250235114001,912,113,403,3,8,0,279,106,765,78,380,3,8,0,196,100,147,35,23,0,0,0,83,6
250235114002,783,341,263,0,33,1,95,50,691,303,259,0,31,1,52,45,92,38,4,0,2,0,43,5
250235114003,845,358,267,2,7,0,133,78,742,325,257,1,7,0,84,68,103,33,10,1,0,0,49,10
250235114004,1176,276,463,5,19,0,316,97,988,202,439,4,19,0,239,85,188,74,24,1,0,0,77,12
250235115001,988,174,331,2,5,0,352,124,852,128,308,1,5,0,303,107,136,46,23,1,0,0,49,17
250235115002,877,164,258,1,17,0,310,127,761,132,246,1,17,0,253,112,116,32,12,0,0,0,57,15
250235115003,1400,408,561,7,39,2,275,108,1234,358,536,7,39,2,203,89,166,50,25,0,0,0,72,19
250235115004,1043,348,317,5,10,4,249,110,904,308,298,1,10,4,179,104,139,40,19,4,0,0,70,6
250235116001,1217,321,428,8,26,0,296,138,1071,273,397,5,25,0,256,115,146,48,31,3,1,0,40,23
250235116002,680,226,291,1,9,0,81,72,617,197,288,0,9,0,61,62,63,29,3,1,0,0,20,10
250235116003,1276,664,313,8,19,1,163,108,1115,595,294,6,19,1,116,84,161,69,19,2,0,0,47,24
250214113022,2055,1771,162,6,56,0,40,20,1865,1636,155,5,56,0,0,13,190,135,7,1,0,0,40,7
250214113023,1157,989,26,3,120,0,7,12,1124,966,26,3,120,0,1,8,33,23,0,0,0,0,6,4
250214121001,1830,1721,15,1,75,0,5,13,1799,1700,15,0,75,0,2,7,31,21,0,1,0,0,3,6
250214121002,1020,977,8,0,27,0,2,6,998,956,7,0,27,0,2,6,22,21,1,0,0,0,0,0
250214121003,2314,2112,22,1,140,0,12,27,2276,2087,21,0,140,0,6,22,38,25,1,1,0,0,6,5
250214121004,1170,1093,10,0,46,0,2,19,1156,1081,10,0,46,0,1,18,14,12,0,0,0,0,1,1
250214122001,1636,1564,16,1,32,0,1,22,1611,1544,16,1,32,0,1,17,25,20,0,0,0,0,0,5
250214122002,1936,1822,6,1,88,0,9,10,1911,1803,3,1,88,0,6,10,25,19,3,0,0,0,3,0
250214123001,1153,1040,10,0,80,0,12,11,1124,1025,10,0,80,0,2,7,29,15,0,0,0,0,10,4
250214123002,1016,911,8,0,79,0,4,14,1000,900,7,0,78,0,2,13,16,11,1,0,1,0,2,1
250214123003,736,639,27,0,65,0,0,5,717,623,24,0,65,0,0,5,19,16,3,0,0,0,0,0
250214123004,1807,1676,14,1,94,0,2,20,1789,1662,14,1,94,0,0,18,18,14,0,0,0,0,2,2
250214131001,1402,1328,9,0,43,0,8,14,1373,1307,9,0,43,0,4,10,29,21,0,0,0,0,4,4
250214131002,846,807,26,0,10,0,2,1,828,792,25,0,10,0,0,1,18,15,1,0,0,0,2,0
250214131003,1222,1129,24,11,34,0,13,11,1190,1106,24,11,34,0,5,10,32,23,0,0,0,0,8,1
250214131004,1159,1002,57,4,66,0,10,20,1125,989,53,4,64,0,1,14,34,13,4,0,2,0,9,6
250214131005,1225,1029,86,2,34,0,27,47,1165,991,82,2,34,0,15,41,60,38,4,0,0,0,12,6
250214132001,1183,1070,47,0,40,0,16,10,1148,1051,47,0,40,0,1,9,35,19,0,0,0,0,15,1
250214132002,1542,1417,62,1,19,4,16,23,1475,1386,55,1,19,3,3,8,67,31,7,0,0,1,13,15
250214132003,1282,1150,42,8,51,0,22,9,1240,1122,41,6,51,0,14,6,42,28,1,2,0,0,8,3
250214132004,2072,1776,117,3,71,0,57,48,1972,1732,111,3,71,0,23,32,100,44,6,0,0,0,34,16
250214133001,2544,2047,229,2,164,0,43,59,2411,1969,207,2,164,0,24,45,133,78,22,0,0,0,19,14
250214133002,1215,1167,7,3,11,0,14,13,1192,1157,7,0,11,0,7,10,23,10,0,3,0,0,7,3
250214133003,1195,1139,6,0,39,0,1,10,1173,1119,6,0,39,0,0,9,22,20,0,0,0,0,1,1
250214134011,900,835,31,1,8,0,13,12,862,820,24,1,8,0,0,9,38,15,7,0,0,0,13,3
250214134012,1355,1263,38,0,28,0,14,12,1316,1238,37,0,28,0,2,11,39,25,1,0,0,0,12,1
250214134013,912,812,50,0,23,0,4,23,883,788,49,0,23,0,2,21,29,24,1,0,0,0,2,2
250214134021,1288,1055,61,0,135,0,11,26,1253,1039,52,0,135,0,2,25,35,16,9,0,0,0,9,1
250214134022,2004,947,303,7,638,3,52,54,1850,853,286,7,637,1,19,47,154,94,17,0,1,2,33,7
250214134023,952,904,21,0,18,1,3,5,928,885,19,0,18,1,1,4,24,19,2,0,0,0,2,1
250214135001,1552,1167,101,5,209,0,26,44,1456,1118,96,0,209,0,7,26,96,49,5,5,0,0,19,18
250214135002,1241,978,110,1,39,0,75,38,1109,905,110,1,39,0,18,36,132,73,0,0,0,0,57,2
250214135003,1511,1323,56,3,18,0,60,51,1426,1275,52,3,18,0,36,42,85,48,4,0,0,0,24,9
250214141001,885,732,32,0,94,0,1,26,871,723,28,0,94,0,0,26,14,9,4,0,0,0,1,0
250214141002,700,569,38,0,82,0,3,8,684,556,38,0,82,0,1,7,16,13,0,0,0,0,2,1
250214141003,2069,1397,115,0,520,0,8,29,2042,1386,106,0,520,0,3,27,27,11,9,0,0,0,5,2
250214141004,2039,1595,150,0,212,4,27,51,1964,1557,138,0,212,4,9,44,75,38,12,0,0,0,18,7
250214142001,830,663,44,0,94,0,8,21,796,642,42,0,94,0,6,12,34,21,2,0,0,0,2,9
250214142002,2738,2286,81,4,313,0,10,44,2682,2251,78,0,312,0,4,37,56,35,3,4,1,0,6,7
250214142003,1229,1071,41,1,85,0,14,17,1190,1044,40,1,85,0,4,16,39,27,1,0,0,0,10,1
250214142004,2386,2000,77,8,233,2,12,54,2343,1978,68,7,233,2,1,54,43,22,9,1,0,0,11,0
250214143001,2583,2283,93,1,172,0,9,25,2555,2266,93,0,171,0,4,21,28,17,0,1,1,0,5,4
250214143002,801,687,50,1,37,0,6,20,781,675,45,1,37,0,5,18,20,12,5,0,0,0,1,2
250214143003,1352,1214,25,0,80,0,12,21,1331,1193,25,0,80,0,12,21,21,21,0,0,0,0,0,0
250214151011,1691,1525,58,1,66,1,8,32,1666,1516,55,1,65,0,2,27,25,9,3,0,1,1,6,5
250214151012,2841,2455,87,4,253,0,14,28,2778,2412,79,0,250,0,10,27,63,43,8,4,3,0,4,1
250214151021,1862,1623,119,1,92,0,3,24,1822,1599,112,0,92,0,1,18,40,24,7,1,0,0,2,6
250214151022,1109,851,127,3,84,0,23,21,1076,841,122,3,83,0,8,19,33,10,5,0,1,0,15,2
250214151023,2311,1928,120,3,177,0,28,55,2242,1887,114,3,176,0,12,50,69,41,6,0,1,0,16,5
250214151024,1319,1130,103,4,43,0,15,24,1277,1109,99,4,43,0,5,17,42,21,4,0,0,0,10,7
250214151025,864,748,49,1,43,1,17,5,838,728,49,1,43,1,11,5,26,20,0,0,0,0,6,0
250214152001,2765,2429,149,2,109,0,26,50,2676,2381,141,1,108,0,5,40,89,48,8,1,1,0,21,10
250214152002,3085,2246,427,4,261,0,60,87,2936,2179,406,4,261,0,20,66,149,67,21,0,0,0,40,21
250214153001,2467,2216,79,0,143,0,6,23,2431,2191,79,0,143,0,1,17,36,25,0,0,0,0,5,6
250214153002,1247,1122,45,0,48,0,14,18,1223,1108,45,0,48,0,6,16,24,14,0,0,0,0,8,2
250214161011,771,668,27,0,68,1,1,6,760,658,27,0,67,1,1,6,11,10,0,0,1,0,0,0
250214161012,1969,1722,69,0,131,0,23,24,1926,1697,64,0,131,0,14,20,43,25,5,0,0,0,9,4
250214161013,1818,1679,52,0,41,2,15,29,1777,1647,49,0,40,2,12,27,41,32,3,0,1,0,3,2
250214161014,1166,1038,57,0,37,1,4,29,1149,1026,56,0,37,1,0,29,17,12,1,0,0,0,4,0
250214161021,2879,2502,203,0,86,1,30,57,2791,2453,197,0,84,1,7,49,88,49,6,0,2,0,23,8
250214161022,931,736,103,0,45,0,15,32,903,719,98,0,45,0,9,32,28,17,5,0,0,0,6,0
250214162001,1081,369,585,6,30,0,33,58,996,346,563,2,30,0,14,41,85,23,22,4,0,0,19,17
250214162002,827,454,251,6,53,0,28,35,783,449,231,6,53,0,12,32,44,5,20,0,0,0,16,3
250214162003,1020,853,113,0,16,0,8,30,995,838,105,0,16,0,7,29,25,15,8,0,0,0,1,1
250214162004,686,535,106,5,10,0,4,26,660,525,102,1,10,0,1,21,26,10,4,4,0,0,3,5
250214162005,832,384,307,0,44,0,39,58,768,364,294,0,44,0,13,53,64,20,13,0,0,0,26,5
250214162006,866,491,284,0,25,0,40,26,817,476,267,0,25,0,27,22,49,15,17,0,0,0,13,4
250214162007,1339,408,781,2,68,0,45,35,1244,378,757,2,68,0,12,27,95,30,24,0,0,0,33,8
250214163001,1461,1269,99,4,48,0,22,19,1415,1241,91,3,47,0,16,17,46,28,8,1,1,0,6,2
250214163002,803,434,287,6,15,0,21,40,767,422,274,6,15,0,10,40,36,12,13,0,0,0,11,0
250214163003,862,642,162,2,29,0,5,22,823,618,157,2,27,0,1,18,39,24,5,0,2,0,4,4
250214163004,843,688,57,2,50,0,6,40,816,670,57,2,50,0,1,36,27,18,0,0,0,0,5,4
250214163005,780,482,229,4,21,0,17,27,742,466,222,4,21,0,8,21,38,16,7,0,0,0,9,6
250214164001,789,695,21,1,46,0,7,19,761,683,15,1,46,0,3,13,28,12,6,0,0,0,4,6
250214164002,664,609,11,0,33,0,2,9,659,606,11,0,33,0,1,8,5,3,0,0,0,0,1,1
250214164003,811,766,2,0,32,0,0,11,800,755,2,0,32,0,0,11,11,11,0,0,0,0,0,0
250214164004,797,750,9,0,25,0,9,4,787,745,9,0,25,0,5,3,10,5,0,0,0,0,4,1
250214164005,1028,953,21,0,34,0,4,16,1015,943,21,0,34,0,3,14,13,10,0,0,0,0,1,2
250214164006,978,896,17,1,46,0,1,17,971,890,17,1,46,0,0,17,7,6,0,0,0,0,1,0
250214164007,1002,878,19,0,85,0,2,18,997,874,19,0,85,0,1,18,5,4,0,0,0,0,1,0
250214171001,770,388,14,0,345,0,11,12,744,376,14,0,345,0,0,9,26,12,0,0,0,0,11,3
250214171002,793,604,19,0,153,0,9,8,778,596,17,0,153,0,6,6,15,8,2,0,0,0,3,2
250214171003,858,540,30,1,270,0,3,14,846,534,29,0,270,0,0,13,12,6,1,1,0,0,3,1
250214171004,1015,824,21,3,149,0,2,16,996,812,19,3,147,0,0,15,19,12,2,0,2,0,2,1
250214171005,828,608,7,2,186,5,4,16,815,601,5,2,186,5,2,14,13,7,2,0,0,0,2,2
250214172001,2743,1219,102,1,1329,1,42,49,2664,1184,101,1,1328,1,4,45,79,35,1,0,1,0,38,4
250214172002,725,335,34,0,346,0,6,4,716,334,33,0,345,0,3,1,9,1,1,0,1,0,3,3
250214172003,961,326,20,0,588,0,13,14,939,321,16,0,586,0,3,13,22,5,4,0,2,0,10,1
250214172004,993,429,20,1,534,0,3,6,984,422,20,0,534,0,2,6,9,7,0,1,0,0,1,0
250214172005,1029,620,11,0,370,0,11,17,1010,611,10,0,370,0,2,17,19,9,1,0,0,0,9,0
250214172006,1055,813,32,0,182,1,3,24,1040,802,31,0,181,1,2,23,15,11,1,0,1,0,1,1
250214172007,676,353,3,0,296,0,6,18,671,349,3,0,296,0,5,18,5,4,0,0,0,0,1,0
250214173001,1781,1308,69,2,354,0,19,29,1732,1280,62,2,354,0,6,28,49,28,7,0,0,0,13,1
250214173002,900,807,27,3,41,1,11,10,877,791,26,3,41,1,5,10,23,16,1,0,0,0,6,0
250214174001,1125,1074,5,4,24,0,7,11,1107,1067,3,4,24,0,0,9,18,7,2,0,0,0,7,2
250214174002,817,749,17,2,28,0,5,16,796,734,16,2,28,0,1,15,21,15,1,0,0,0,4,1
250214174003,624,603,2,2,14,0,2,1,615,596,2,2,14,0,0,1,9,7,0,0,0,0,2,0
250214175011,793,582,22,0,181,0,0,8,788,580,22,0,181,0,0,5,5,2,0,0,0,0,0,3
250214175012,1357,878,15,2,431,0,13,18,1319,854,14,2,430,0,2,17,38,24,1,0,1,0,11,1
250214175013,1392,858,61,1,407,0,14,51,1352,833,58,0,407,0,6,48,40,25,3,1,0,0,8,3
250214175014,1462,583,12,0,835,0,17,15,1440,570,12,0,834,0,9,15,22,13,0,0,1,0,8,0
250214175021,1064,556,35,1,449,0,4,19,1024,525,30,1,448,0,1,19,40,31,5,0,1,0,3,0
250214175022,1121,406,38,3,652,0,10,12,1091,391,36,3,652,0,2,7,30,15,2,0,0,0,8,5
250214175023,887,358,23,2,473,0,13,18,852,339,21,2,473,0,1,16,35,19,2,0,0,0,12,2
250214175024,1567,950,42,1,526,0,19,29,1527,930,38,0,526,0,5,28,40,20,4,1,0,0,14,1
250214176011,763,637,10,1,101,0,5,9,752,629,10,1,101,0,2,9,11,8,0,0,0,0,3,0
250214176012,1849,1375,67,0,347,0,26,34,1775,1336,58,0,347,0,2,32,74,39,9,0,0,0,24,2
250214176013,1239,730,22,1,470,0,2,14,1217,711,22,1,469,0,1,13,22,19,0,0,1,0,1,1
250214176014,1345,613,41,1,648,0,20,22,1312,595,41,1,648,0,6,21,33,18,0,0,0,0,14,1
250214176021,1328,1128,24,3,143,0,12,18,1301,1118,18,3,143,0,3,16,27,10,6,0,0,0,9,2
250214176022,1673,1028,17,6,587,0,8,27,1635,1005,16,5,584,0,2,23,38,23,1,1,3,0,6,4
250214176023,2154,1289,70,3,714,0,25,53,2079,1245,61,3,714,0,6,50,75,44,9,0,0,0,19,3
250214177011,1556,1091,111,2,307,0,11,34,1521,1072,110,1,307,0,5,26,35,19,1,1,0,0,6,8
250214177012,869,733,13,0,101,0,4,18,859,727,13,0,101,0,2,16,10,6,0,0,0,0,2,2
250214177013,1541,983,75,0,416,0,23,44,1470,938,75,0,415,0,10,32,71,45,0,0,1,0,13,12
250214177014,1451,1048,91,4,255,0,39,14,1396,1019,84,4,254,0,22,13,55,29,7,0,1,0,17,1
250214177021,720,678,0,0,39,0,0,3,708,666,0,0,39,0,0,3,12,12,0,0,0,0,0,0
250214177022,1050,758,123,4,133,0,14,18,1007,728,118,3,133,0,10,15,43,30,5,1,0,0,4,3
250214177023,995,910,9,1,65,0,0,10,985,900,9,1,65,0,0,10,10,10,0,0,0,0,0,0
250214178011,1089,1000,22,2,36,0,6,23,1061,981,20,1,36,0,2,21,28,19,2,1,0,0,4,2
250214178012,842,799,1,4,21,0,10,7,819,785,1,4,20,0,2,7,23,14,0,0,1,0,8,0
250214178013,1228,1135,10,4,54,0,12,13,1208,1127,10,4,51,0,5,11,20,8,0,0,3,0,7,2
250214178014,708,645,14,3,24,1,5,16,692,635,13,3,24,1,5,11,16,10,1,0,0,0,0,5
250214178015,1576,1351,62,1,107,0,15,40,1527,1323,55,1,107,0,8,33,49,28,7,0,0,0,7,7
250214178021,1707,983,128,0,510,0,34,52,1644,961,119,0,510,0,13,41,63,22,9,0,0,0,21,11
250214178022,1443,595,142,14,606,0,22,64,1379,573,128,10,603,0,7,58,64,22,14,4,3,0,15,6
250214179011,1489,1113,60,1,277,1,14,23,1443,1083,58,1,277,1,5,18,46,30,2,0,0,0,9,5
250214179012,1189,674,184,9,239,4,32,47,1126,649,172,6,238,4,18,39,63,25,12,3,1,0,14,8
250214179013,1783,1390,100,6,199,0,55,33,1740,1373,95,6,198,0,39,29,43,17,5,0,1,0,16,4
250214179014,746,404,30,1,256,0,17,38,727,392,30,1,256,0,11,37,19,12,0,0,0,0,6,1
250214179015,841,587,55,1,158,0,21,19,809,569,55,1,158,0,13,13,32,18,0,0,0,0,8,6
250214179021,1299,819,70,1,227,0,135,47,1223,782,68,0,226,0,100,47,76,37,2,1,1,0,35,0
250214179022,1315,911,86,1,261,0,36,20,1253,872,80,1,260,0,22,18,62,39,6,0,1,0,14,2
250214179023,928,663,43,1,167,0,29,25,886,639,40,1,167,0,16,23,42,24,3,0,0,0,13,2
250214180021,1848,1229,107,3,430,0,35,44,1772,1192,105,2,430,0,13,30,76,37,2,1,0,0,22,14
250214180022,811,688,9,1,90,0,12,11,791,677,9,1,90,0,6,8,20,11,0,0,0,0,6,3
250214180023,964,813,35,2,73,0,19,22,941,803,32,2,73,0,15,16,23,10,3,0,0,0,4,6
250214180024,1095,765,42,2,208,0,46,32,1042,743,40,1,208,0,24,26,53,22,2,1,0,0,22,6
250214180025,2302,803,163,14,1176,0,90,56,2186,750,159,6,1172,0,48,51,116,53,4,8,4,0,42,5
250214180031,2481,1802,180,3,351,4,63,78,2328,1713,168,1,351,4,23,68,153,89,12,2,0,0,40,10
250214180041,1462,891,125,9,346,0,45,46,1380,853,115,9,343,0,21,39,82,38,10,0,3,0,24,7
250214180042,851,569,38,0,205,0,23,16,816,558,38,0,205,0,3,12,35,11,0,0,0,0,20,4
250214180043,1967,1244,176,9,422,1,51,64,1865,1188,159,2,420,1,36,59,102,56,17,7,2,0,15,5
250214181011,1471,1171,9,4,262,0,7,18,1446,1154,9,4,262,0,4,13,25,17,0,0,0,0,3,5
250214181012,2575,1762,177,8,533,0,35,60,2459,1698,174,7,531,0,10,39,116,64,3,1,2,0,25,21
250214181013,791,509,43,1,224,1,10,3,769,493,43,1,223,1,5,3,22,16,0,0,1,0,5,0
250214181021,959,810,18,0,93,0,10,28,916,781,16,0,91,0,1,27,43,29,2,0,2,0,9,1
250214181022,2418,1558,330,9,299,1,145,76,2255,1488,319,8,299,1,76,64,163,70,11,1,0,0,69,12
250214182001,1512,1160,58,1,247,0,19,27,1476,1145,52,0,246,0,11,22,36,15,6,1,1,0,8,5
250214182002,1754,1180,219,3,219,0,65,68,1642,1132,204,1,211,0,33,61,112,48,15,2,8,0,32,7
250214182003,773,535,94,1,82,0,39,22,711,501,80,1,82,0,28,19,62,34,14,0,0,0,11,3
250214182004,2185,1768,64,1,283,0,16,53,2110,1714,59,1,283,0,7,46,75,54,5,0,0,0,9,7
250214191001,1957,1619,76,1,193,0,29,39,1917,1593,73,1,190,0,24,36,40,26,3,0,3,0,5,3
250214191002,1516,1332,14,0,102,0,31,37,1480,1318,14,0,102,0,14,32,36,14,0,0,0,0,17,5
250214191003,1515,1362,15,7,93,2,16,20,1481,1357,12,1,93,0,1,17,34,5,3,6,0,2,15,3
250214191004,703,634,14,0,42,0,9,4,699,630,14,0,42,0,9,4,4,4,0,0,0,0,0,0
250214192001,2286,1951,122,1,125,1,37,49,2196,1904,113,1,125,1,7,45,90,47,9,0,0,0,30,4
250214192002,693,642,6,4,36,0,3,2,688,637,6,4,36,0,3,2,5,5,0,0,0,0,0,0
250214192003,800,700,15,3,59,0,11,12,772,680,15,3,59,0,4,11,28,20,0,0,0,0,7,1
250214192004,1223,1137,9,3,64,0,4,6,1211,1126,8,3,64,0,4,6,12,11,1,0,0,0,0,0
250214193001,1249,795,188,3,180,0,23,60,1181,760,174,1,173,0,19,54,68,35,14,2,7,0,4,6
250214193002,708,645,10,8,14,8,14,9,677,625,10,8,14,8,7,5,31,20,0,0,0,0,7,4
250214193003,916,636,121,3,74,0,35,47,834,606,112,3,74,0,9,30,82,30,9,0,0,0,26,17
250214193004,990,877,2,2,89,0,12,8,957,853,2,0,89,0,8,5,33,24,0,2,0,0,4,3
250214194001,846,746,10,0,60,1,15,14,818,730,9,0,60,1,9,9,28,16,1,0,0,0,6,5
250214194002,1021,922,8,0,67,0,10,14,1001,914,8,0,67,0,0,12,20,8,0,0,0,0,10,2
250214194003,1299,1107,50,1,109,0,15,17,1266,1085,50,1,109,0,9,12,33,22,0,0,0,0,6,5
250214195001,932,813,36,0,59,0,9,15,908,793,36,0,59,0,7,13,24,20,0,0,0,0,2,2
250214195002,2145,1877,27,2,197,0,13,29,2114,1860,26,2,196,0,4,26,31,17,1,0,1,0,9,3
250214196001,1374,1029,90,4,179,0,39,33,1311,1000,82,4,179,0,17,29,63,29,8,0,0,0,22,4
250214196002,1068,963,15,4,77,0,4,5,1054,959,11,3,77,0,0,4,14,4,4,1,0,0,4,1
250214196003,2220,1989,32,2,151,0,21,25,2189,1961,32,2,151,0,20,23,31,28,0,0,0,0,1,2
250214196004,2104,1966,9,2,108,0,5,14,2087,1954,9,0,105,0,5,14,17,12,0,2,3,0,0,0
250214197001,1340,1154,13,1,147,0,14,11,1315,1136,13,1,147,0,8,10,25,18,0,0,0,0,6,1
250214197002,2481,2241,12,3,198,0,14,13,2444,2211,10,3,198,0,9,13,37,30,2,0,0,0,5,0
250214198001,1643,1444,14,1,132,0,21,31,1614,1424,12,0,132,0,18,28,29,20,2,1,0,0,3,3
250214198002,1183,1001,42,7,58,0,35,40,1145,985,39,5,58,0,29,29,38,16,3,2,0,0,6,11
250214198003,1532,1394,22,0,88,0,11,17,1495,1370,21,0,88,0,1,15,37,24,1,0,0,0,10,2
250214201001,868,393,221,3,189,0,46,16,797,359,216,3,189,0,20,10,71,34,5,0,0,0,26,6
250214201002,987,407,297,8,157,0,71,47,905,383,291,7,156,0,31,37,82,24,6,1,1,0,40,10
250214201003,946,409,356,1,123,0,25,32,869,367,342,1,123,0,9,27,77,42,14,0,0,0,16,5
250214201004,2539,1249,758,2,390,0,65,75,2418,1201,735,2,390,0,19,71,121,48,23,0,0,0,46,4
250214201005,2464,882,1000,4,432,0,69,77,2305,810,971,2,432,0,26,64,159,72,29,2,0,0,43,13
250214202011,877,377,308,7,118,0,34,33,836,359,301,2,118,0,27,29,41,18,7,5,0,0,7,4
250214202012,2628,1076,997,0,364,1,104,86,2472,1012,969,0,363,1,55,72,156,64,28,0,1,0,49,14
250214202021,1096,506,371,5,130,0,40,44,1025,493,362,3,129,0,10,28,71,13,9,2,1,0,30,16
250214202022,1747,701,645,11,262,0,91,37,1627,666,611,4,262,0,56,28,120,35,34,7,0,0,35,9
250214202023,3460,1193,1599,19,379,0,118,152,3248,1121,1560,11,378,0,52,126,212,72,39,8,1,0,66,26
250214203011,901,460,294,6,58,0,41,42,822,435,288,0,58,0,14,27,79,25,6,6,0,0,27,15
250214203012,1490,596,615,2,143,1,64,69,1368,554,586,1,143,0,35,49,122,42,29,1,0,1,29,20
250214203013,2575,1214,929,13,221,0,123,75,2354,1126,870,8,221,0,70,59,221,88,59,5,0,0,53,16
250214203014,1831,811,577,2,304,0,70,67,1724,761,560,2,302,0,44,55,107,50,17,0,2,0,26,12
250214203021,1677,691,708,7,203,2,32,34,1622,656,697,7,201,2,27,32,55,35,11,0,2,0,5,2
250214203022,1017,431,405,1,102,0,43,35,950,397,400,1,102,0,26,24,67,34,5,0,0,0,17,11
250214203023,1075,526,390,1,83,0,47,28,1012,516,368,1,83,0,20,24,63,10,22,0,0,0,27,4
250214203024,2382,973,985,5,245,0,75,99,2250,905,954,4,245,0,58,84,132,68,31,1,0,0,17,15
250214203025,1552,467,853,11,95,0,45,81,1451,432,837,10,94,0,12,66,101,35,16,1,1,0,33,15
250214211001,1635,1240,217,8,34,0,59,77,1529,1196,208,6,33,0,26,60,106,44,9,2,1,0,33,17
250214211002,670,562,66,0,16,0,21,5,635,548,60,0,16,0,6,5,35,14,6,0,0,0,15,0
250214211003,2036,1629,189,15,83,1,44,75,1940,1590,188,11,82,1,7,61,96,39,1,4,1,0,37,14
250214211004,779,641,97,2,15,0,11,13,755,628,93,2,15,0,6,11,24,13,4,0,0,0,5,2
250214212001,999,841,100,0,16,0,4,38,962,823,93,0,16,0,3,27,37,18,7,0,0,0,1,11
250214212002,1159,1041,63,1,30,1,8,15,1121,1012,61,1,30,0,6,11,38,29,2,0,0,1,2,4
250214212003,1232,1097,72,0,20,0,24,19,1189,1079,63,0,20,0,9,18,43,18,9,0,0,0,15,1
250214212004,1457,1213,88,2,80,1,52,21,1392,1186,77,2,78,1,28,20,65,27,11,0,2,0,24,1
250214212005,824,671,75,0,20,0,32,26,794,659,75,0,20,0,17,23,30,12,0,0,0,0,15,3
250214221001,1110,1061,3,0,18,0,16,12,1093,1049,3,0,18,0,11,12,17,12,0,0,0,0,5,0
250214221002,1279,1218,18,0,26,0,3,14,1254,1202,13,0,26,0,0,13,25,16,5,0,0,0,3,1
250214221003,1919,1748,43,0,64,0,39,25,1874,1719,38,0,62,0,33,22,45,29,5,0,2,0,6,3
250214221004,985,902,13,1,32,0,20,17,967,890,12,0,32,0,17,16,18,12,1,1,0,0,3,1
250214222001,26,24,0,0,0,0,2,0,24,24,0,0,0,0,0,0,2,0,0,0,0,0,2,0
250214222002,1417,1302,25,7,64,0,3,16,1404,1297,24,7,64,0,0,12,13,5,1,0,0,0,3,4
250214222003,1078,1045,9,0,13,0,3,8,1069,1043,8,0,13,0,0,5,9,2,1,0,0,0,3,3
250214222004,886,866,5,0,11,0,4,0,871,851,5,0,11,0,4,0,15,15,0,0,0,0,0,0
250214222005,1863,1497,71,1,176,0,59,59,1812,1468,70,1,176,0,47,50,51,29,1,0,0,0,12,9
250235442004,1703,1645,11,1,8,1,11,26,1689,1638,11,1,8,1,7,23,14,7,0,0,0,0,4,3
250235451001,1487,1259,58,4,11,0,103,52,1456,1241,55,4,11,0,96,49,31,18,3,0,0,0,7,3
250235451002,789,674,33,3,5,1,41,32,769,663,32,0,5,1,36,32,20,11,1,3,0,0,5,0
250235451003,2413,2183,46,13,24,0,76,71,2366,2147,43,13,24,0,69,70,47,36,3,0,0,0,7,1
250235451004,1757,1528,64,7,8,0,68,82,1731,1515,62,5,8,0,63,78,26,13,2,2,0,0,5,4
250235452001,635,449,38,2,2,0,66,78,601,426,37,2,2,0,62,72,34,23,1,0,0,0,4,6
250235452002,1666,1492,38,11,28,3,51,43,1620,1463,35,11,28,3,39,41,46,29,3,0,0,0,12,2
250235452003,1426,1276,37,11,4,0,54,44,1384,1252,33,9,4,0,49,37,42,24,4,2,0,0,5,7
250235452004,1942,1652,55,10,13,1,121,90,1876,1623,47,9,10,1,106,80,66,29,8,1,3,0,15,10
250235453001,1573,1109,156,10,16,0,146,136,1535,1092,149,9,16,0,141,128,38,17,7,1,0,0,5,8
250235453002,761,716,11,0,7,0,15,12,754,710,11,0,7,0,14,12,7,6,0,0,0,0,1,0
250235453003,1016,910,35,18,3,0,20,30,1000,904,35,15,3,0,17,26,16,6,0,3,0,0,3,4
250235453004,1063,938,45,16,2,0,25,37,1028,917,43,14,2,0,17,35,35,21,2,2,0,0,8,2
250235454001,783,714,17,7,1,0,8,36,773,710,17,7,1,0,6,32,10,4,0,0,0,0,2,4
250235454002,827,749,27,1,7,0,18,25,806,738,21,1,7,0,14,25,21,11,6,0,0,0,4,0
250235454003,746,701,17,0,3,0,15,10,744,699,17,0,3,0,15,10,2,2,0,0,0,0,0,0
250235454004,1556,1330,49,16,8,0,75,78,1517,1308,49,15,8,0,66,71,39,22,0,1,0,0,9,7
250235454005,1382,1194,43,12,8,0,48,77,1360,1186,42,11,8,0,40,73,22,8,1,1,0,0,8,4
250235601001,686,655,6,3,1,0,20,1,678,651,6,3,1,0,16,1,8,4,0,0,0,0,4,0
250235601002,827,792,8,0,6,0,9,12,820,785,8,0,6,0,9,12,7,7,0,0,0,0,0,0
250235601003,1099,1068,2,1,3,0,7,18,1089,1060,2,0,3,0,6,18,10,8,0,1,0,0,1,0
250235601004,569,554,0,0,3,1,7,4,565,550,0,0,3,1,7,4,4,4,0,0,0,0,0,0
250235601005,1393,1330,14,3,16,0,13,17,1373,1318,14,3,16,0,7,15,20,12,0,0,0,0,6,2
250235601006,1471,1413,11,1,7,0,17,22,1463,1406,11,1,7,0,16,22,8,7,0,0,0,0,1,0
250235611001,1503,1391,23,3,6,0,48,32,1488,1379,23,3,6,0,47,30,15,12,0,0,0,0,1,2
250235611002,899,862,8,1,2,2,9,15,892,859,8,1,2,2,7,13,7,3,0,0,0,0,2,2
250235611003,877,826,9,0,8,0,17,17,874,824,9,0,8,0,17,16,3,2,0,0,0,0,0,1
250235611004,927,886,16,1,1,0,11,12,919,878,16,1,1,0,11,12,8,8,0,0,0,0,0,0
250235611005,701,585,26,0,14,0,42,34,682,569,26,0,14,0,40,33,19,16,0,0,0,0,2,1
250235612001,2929,2619,128,3,45,0,54,80,2810,2563,116,3,43,0,16,69,119,56,12,0,2,0,38,11
250239900030,0,0,0,0,0,0,0,0,0,0,0,0,0,0,0,0,0,0,0,0,0,0,0,0
250250001001,1422,782,131,3,197,0,236,73,1146,685,109,0,197,0,109,46,276,97,22,3,0,0,127,27
250250001002,1044,737,44,1,135,0,74,53,940,685,41,1,135,0,37,41,104,52,3,0,0,0,37,12
250250001003,785,621,57,0,56,0,28,23,730,605,38,0,56,0,10,21,55,16,19,0,0,0,18,2
250250001004,1003,608,68,2,81,0,175,69,817,533,61,2,80,0,94,47,186,75,7,0,1,0,81,22
250250002011,935,698,74,3,84,0,43,33,829,639,72,1,81,0,14,22,106,59,2,2,3,0,29,11
250250002012,790,657,20,0,73,0,22,18,746,632,16,0,73,0,13,12,44,25,4,0,0,0,9,6
250250002013,1394,992,132,5,117,2,108,38,1216,927,118,4,116,2,26,23,178,65,14,1,1,0,82,15
250250002014,735,571,50,0,53,0,36,25,656,530,38,0,52,0,17,19,79,41,12,0,1,0,19,6
250250002021,1487,1154,45,2,195,0,51,40,1369,1091,41,2,195,0,14,26,118,63,4,0,0,0,37,14
250250002022,825,640,28,1,105,0,30,21,766,602,27,1,105,0,12,19,59,38,1,0,0,0,18,2
250250002023,748,615,9,3,98,0,13,10,712,591,7,3,98,0,6,7,36,24,2,0,0,0,7,3
250250002024,825,211,248,11,129,1,176,49,442,86,198,6,127,0,18,7,383,125,50,5,2,1,158,42
250250003011,638,434,42,6,96,0,26,34,567,393,41,0,96,0,13,24,71,41,1,6,0,0,13,10
250250003012,790,654,41,0,78,0,6,11,771,645,37,0,78,0,0,11,19,9,4,0,0,0,6,0
250250003013,600,537,8,0,42,0,9,4,579,521,8,0,42,0,4,4,21,16,0,0,0,0,5,0
250250003014,712,525,40,0,82,0,43,22,633,491,38,0,79,0,7,18,79,34,2,0,3,0,36,4
250250003021,1547,1287,48,0,162,0,30,20,1401,1164,47,0,161,0,16,13,146,123,1,0,1,0,14,7
250250003022,1595,1185,48,2,291,0,26,43,1512,1131,42,2,288,0,14,35,83,54,6,0,3,0,12,8
250250004011,1498,1105,52,4,236,0,39,62,1382,1041,48,0,236,0,9,48,116,64,4,4,0,0,30,14
250250004012,1138,818,29,2,232,0,35,22,1059,769,27,2,232,0,9,20,79,49,2,0,0,0,26,2
250250004013,1027,788,21,0,167,0,29,22,970,769,19,0,167,0,4,11,57,19,2,0,0,0,25,11
250250004014,2009,1533,42,0,397,1,14,22,1974,1510,38,0,397,1,8,20,35,23,4,0,0,0,6,2
250250004021,1525,1177,31,0,244,2,28,43,1459,1133,28,0,244,2,12,40,66,44,3,0,0,0,16,3
250250004022,995,789,26,0,160,0,9,11,944,747,26,0,159,0,1,11,51,42,0,0,1,0,8,0
250250004023,1128,897,15,0,140,0,36,40,1056,854,15,0,140,0,15,32,72,43,0,0,0,0,21,8
250250005021,883,717,23,2,105,0,10,26,830,680,23,1,105,0,1,20,53,37,0,1,0,0,9,6
250250005022,715,607,14,1,70,0,9,14,660,563,13,1,70,0,1,12,55,44,1,0,0,0,8,2
250250005023,1619,1308,52,4,197,2,34,22,1520,1247,45,3,196,2,8,19,99,61,7,1,1,0,26,3
250250005024,3086,2394,197,1,335,0,54,105,2847,2229,187,1,333,0,6,91,239,165,10,0,2,0,48,14
250250005031,762,617,11,1,98,0,16,19,726,597,10,0,98,0,4,17,36,20,1,1,0,0,12,2
250250005032,1449,1181,46,2,167,0,21,32,1389,1142,45,2,166,0,7,27,60,39,1,0,1,0,14,5
250250005041,1326,997,71,1,188,1,32,36,1205,932,59,1,186,1,2,24,121,65,12,0,2,0,30,12
250250005042,1419,1181,36,0,155,0,21,26,1348,1136,35,0,153,0,1,23,71,45,1,0,2,0,20,3
250250005043,1380,1140,39,2,151,0,21,27,1297,1079,37,2,151,0,5,23,83,61,2,0,0,0,16,4
250250005044,860,739,45,2,47,2,9,16,817,715,37,1,47,2,3,12,43,24,8,1,0,0,6,4
250250006011,762,584,15,0,125,0,25,13,731,559,15,0,125,0,19,13,31,25,0,0,0,0,6,0
250250006012,1077,822,38,1,168,0,26,22,1019,785,35,1,167,0,10,21,58,37,3,0,1,0,16,1
250250006013,664,501,15,0,94,0,30,24,606,467,10,0,94,0,12,23,58,34,5,0,0,0,18,1
250250006014,1068,738,26,1,154,0,108,41,927,669,22,1,154,0,53,28,141,69,4,0,0,0,55,13
250250006021,1457,1049,51,3,228,2,65,59,1290,952,50,1,227,2,13,45,167,97,1,2,1,0,52,14
250250006022,1111,827,52,3,169,1,23,36,1043,785,49,1,169,0,10,29,68,42,3,2,0,1,13,7
250250006023,1406,525,373,8,240,0,199,61,1000,400,325,1,239,0,5,30,406,125,48,7,1,0,194,31
250250007011,845,592,40,4,129,0,57,23,767,559,38,0,129,0,20,21,78,33,2,4,0,0,37,2
250250007012,581,414,40,0,79,2,20,26,510,376,30,0,79,2,3,20,71,38,10,0,0,0,17,6
250250007013,599,478,21,2,76,1,12,9,568,464,17,2,75,1,2,7,31,14,4,0,1,0,10,2
250250007014,922,719,41,0,128,0,8,26,879,689,41,0,128,0,2,19,43,30,0,0,0,0,6,7
250250007015,1499,1023,56,2,318,1,54,45,1389,962,53,2,317,1,15,39,110,61,3,0,1,0,39,6
250250007031,1308,774,64,0,342,0,70,58,1198,710,57,0,337,0,44,50,110,64,7,0,5,0,26,8
250250007032,1483,1047,29,3,330,1,29,44,1411,998,28,3,325,1,13,43,72,49,1,0,5,0,16,1
250250007041,1763,1301,64,4,270,2,59,63,1617,1200,57,1,266,2,39,52,146,101,7,3,4,0,20,11
250250007042,770,517,33,0,171,0,34,15,707,483,33,0,170,0,9,12,63,34,0,0,1,0,25,3
250250007043,1135,754,59,1,267,2,32,20,1052,698,55,0,267,1,14,17,83,56,4,1,0,1,18,3
250250007044,1133,637,161,8,171,1,104,51,850,492,143,2,171,1,11,30,283,145,18,6,0,0,93,21
250250008021,1305,927,39,1,272,1,21,44,1244,886,39,1,272,1,6,39,61,41,0,0,0,0,15,5
250250008022,2290,1171,147,8,364,2,422,176,1651,932,129,2,363,2,133,90,639,239,18,6,1,0,289,86
250250008023,817,563,30,0,86,0,117,21,670,510,29,0,83,0,35,13,147,53,1,0,3,0,82,8
250250008024,1903,1172,83,9,305,0,255,79,1393,907,63,1,304,0,67,51,510,265,20,8,1,0,188,28
250250008025,1821,1132,60,4,545,0,31,49,1712,1057,58,2,543,0,9,43,109,75,2,2,2,0,22,6
250250008031,3103,1802,263,10,795,1,82,150,2809,1606,251,8,788,1,19,136,294,196,12,2,7,0,63,14
250250008032,3481,2531,142,0,620,0,51,137,3199,2329,133,0,612,0,6,119,282,202,9,0,8,0,45,18
250250101031,2111,1291,58,1,641,0,38,82,1949,1184,53,1,637,0,10,64,162,107,5,0,4,0,28,18
250250101032,1144,664,26,2,370,0,20,62,1061,605,24,1,366,0,8,57,83,59,2,1,4,0,12,5
250250101033,1314,845,64,2,327,0,27,49,1212,785,53,2,325,0,3,44,102,60,11,0,2,0,24,5
250250101041,1311,1030,32,0,203,0,18,28,1211,951,32,0,201,0,2,25,100,79,0,0,2,0,16,3
250250101042,2299,1611,57,7,486,0,43,95,2087,1460,56,6,481,0,6,78,212,151,1,1,5,0,37,17
250250101043,1194,798,40,3,285,0,25,43,1097,729,40,2,285,0,6,35,97,69,0,1,0,0,19,8
250250102031,1144,820,49,6,198,0,26,45,1041,754,49,4,196,0,2,36,103,66,0,2,2,0,24,9
250250102032,2369,1652,93,5,456,4,70,89,2134,1495,88,5,451,3,18,74,235,157,5,0,5,1,52,15
250250102033,1563,1141,102,3,216,0,45,56,1434,1075,97,1,216,0,1,44,129,66,5,2,0,0,44,12
250250102034,493,339,54,1,53,1,25,20,391,281,44,1,53,1,0,11,102,58,10,0,0,0,25,9
250250102041,1098,728,36,1,269,0,19,45,1033,685,35,1,268,0,3,41,65,43,1,0,1,0,16,4
250250102042,1197,866,37,2,231,0,22,39,1120,819,35,2,229,0,2,33,77,47,2,0,2,0,20,6
250250102043,878,654,20,1,172,1,10,20,842,630,20,0,172,0,2,18,36,24,0,1,0,1,8,2
250250103001,1810,1185,180,3,232,0,163,47,1552,1114,159,1,229,0,3,46,258,71,21,2,3,0,160,1
250250103002,3051,2373,233,3,252,5,71,114,2852,2267,218,2,248,4,16,97,199,106,15,1,4,1,55,17
250250104031,1236,655,144,2,337,0,50,48,1128,610,138,2,336,0,7,35,108,45,6,0,1,0,43,13
250250104032,1020,615,113,7,187,0,52,46,866,539,99,7,187,0,3,31,154,76,14,0,0,0,49,15
250250104033,747,560,60,1,108,0,3,15,716,537,58,1,105,0,0,15,31,23,2,0,3,0,3,0
250250104041,2353,1681,123,3,414,3,58,71,2182,1580,121,2,413,2,10,54,171,101,2,1,1,1,48,17
250250104042,2548,1977,107,1,354,1,39,69,2413,1888,104,1,349,1,9,61,135,89,3,0,5,0,30,8
250250104043,916,650,39,6,175,1,19,26,836,600,34,1,174,1,4,22,80,50,5,5,1,0,15,4
250250104051,2591,2068,183,2,228,2,36,72,2447,1971,174,2,228,2,8,62,144,97,9,0,0,0,28,10
250250104052,2305,1619,170,12,361,0,54,89,2115,1516,157,4,359,0,5,74,190,103,13,8,2,0,49,15
250250104053,626,313,118,4,130,0,41,20,525,280,95,4,130,0,2,14,101,33,23,0,0,0,39,6
250250104081,1426,1098,55,2,207,1,33,30,1293,1014,50,2,206,1,1,19,133,84,5,0,1,0,32,11
250250105001,953,730,69,1,97,0,24,32,862,672,68,0,97,0,5,20,91,58,1,1,0,0,19,12
250250105002,1099,734,70,2,233,1,24,35,996,660,70,2,233,1,5,25,103,74,0,0,0,0,19,10
250250105003,992,699,183,2,75,0,25,8,895,638,170,2,75,0,2,8,97,61,13,0,0,0,23,0
250250106001,1559,1297,46,2,179,0,11,24,1492,1250,41,1,179,0,1,20,67,47,5,1,0,0,10,4
250250106002,1299,978,95,1,183,0,22,20,1210,909,93,1,182,0,5,20,89,69,2,0,1,0,17,0
250250107011,1032,856,45,1,81,0,19,30,960,806,43,1,80,0,4,26,72,50,2,0,1,0,15,4
250250107012,668,575,8,0,58,0,6,21,644,557,8,0,57,0,4,18,24,18,0,0,1,0,2,3
250250107013,778,674,8,1,76,0,11,8,738,646,6,1,74,0,6,5,40,28,2,0,2,0,5,3
250250107021,663,580,7,0,53,0,10,13,636,563,7,0,53,0,0,13,27,17,0,0,0,0,10,0
250250107022,775,693,30,1,26,1,10,14,738,674,26,1,26,1,0,10,37,19,4,0,0,0,10,4
250250107023,962,871,22,1,45,0,6,17,924,843,20,1,43,0,3,14,38,28,2,0,2,0,3,3
250250108011,664,543,50,2,46,0,8,15,617,515,41,2,46,0,0,13,47,28,9,0,0,0,8,2
250250108012,964,887,6,0,50,0,8,13,927,858,5,0,50,0,3,11,37,29,1,0,0,0,5,2
250250108013,1155,1010,16,1,90,0,6,32,1100,963,16,1,90,0,2,28,55,47,0,0,0,0,4,4
250250108021,1052,911,13,0,89,0,14,25,1010,881,12,0,89,0,5,23,42,30,1,0,0,0,9,2
250250108022,1421,1190,32,0,155,0,13,31,1362,1146,30,0,153,0,4,29,59,44,2,0,2,0,9,2
250250108023,586,529,5,0,35,0,7,10,568,515,5,0,35,0,6,7,18,14,0,0,0,0,1,3
250250201011,767,726,1,0,25,0,3,12,750,711,1,0,25,0,3,10,17,15,0,0,0,0,0,2
250250201012,896,830,6,1,37,0,4,18,870,810,6,1,36,0,4,13,26,20,0,0,1,0,0,5
250250201013,1268,1181,11,0,55,0,12,9,1210,1135,8,0,55,0,4,8,58,46,3,0,0,0,8,1
250250201014,1262,1159,11,0,70,1,12,9,1224,1126,11,0,70,1,8,8,38,33,0,0,0,0,4,1
250250202001,1266,1075,35,0,101,0,25,30,1195,1033,33,0,99,0,2,28,71,42,2,0,2,0,23,2
250250202002,1259,1075,82,1,67,0,11,23,1195,1028,78,1,67,0,3,18,64,47,4,0,0,0,8,5
250250202003,1124,1010,10,2,71,0,10,21,1085,978,10,2,70,0,5,20,39,32,0,0,1,0,5,1
250250203011,350,247,22,1,70,0,5,5,329,234,19,1,70,0,1,4,21,13,3,0,0,0,4,1
250250203012,1673,1238,32,1,347,0,18,37,1586,1169,32,1,346,0,3,35,87,69,0,0,1,0,15,2
250250604001,1021,986,5,0,13,0,2,15,1013,980,5,0,13,0,1,14,8,6,0,0,0,0,1,1
250250604002,988,962,4,0,14,1,0,7,976,950,4,0,14,1,0,7,12,12,0,0,0,0,0,0
250250604003,842,815,11,1,8,0,0,7,836,810,11,1,8,0,0,6,6,5,0,0,0,0,0,1
250250604004,1093,1029,8,1,30,0,17,8,1050,1002,8,1,30,0,1,8,43,27,0,0,0,0,16,0
250250604005,960,894,23,5,21,1,7,9,939,884,22,3,20,1,0,9,21,10,1,2,1,0,7,0
250250605011,699,680,1,1,6,0,6,5,686,674,1,0,6,0,2,3,13,6,0,1,0,0,4,2
250250605012,868,843,3,1,17,1,1,2,861,838,2,1,17,1,0,2,7,5,1,0,0,0,1,0
250250605013,717,691,4,1,12,0,3,6,705,683,4,1,12,0,1,4,12,8,0,0,0,0,2,2
250250605014,631,607,2,0,6,0,4,12,615,601,2,0,6,0,0,6,16,6,0,0,0,0,4,6
250250605015,656,558,13,0,58,0,8,19,632,547,13,0,58,0,2,12,24,11,0,0,0,0,6,7
250250606001,2357,2110,33,7,150,1,17,39,2265,2039,29,7,150,1,6,33,92,71,4,0,0,0,11,6
250250607001,741,221,228,0,100,0,149,43,455,136,194,0,94,0,13,18,286,85,34,0,6,0,136,25
250250607002,1152,351,261,5,94,0,344,97,561,218,187,1,91,0,24,40,591,133,74,4,3,0,320,57
250250608001,655,621,2,0,16,0,9,7,640,609,2,0,16,0,8,5,15,12,0,0,0,0,1,2
250250608002,757,709,10,5,19,0,4,10,745,705,7,5,19,0,0,9,12,4,3,0,0,0,4,1
250250608003,886,819,6,4,46,1,1,9,862,802,6,0,46,1,0,7,24,17,0,4,0,0,1,2
250250608004,1666,1481,25,2,102,0,32,24,1611,1461,24,1,102,0,3,20,55,20,1,1,0,0,29,4
250250610001,1033,969,8,1,16,0,9,30,995,948,7,0,16,0,3,21,38,21,1,1,0,0,6,9
250250610002,1164,296,342,15,148,0,270,93,666,191,262,3,148,0,35,27,498,105,80,12,0,0,235,66
250250610003,901,261,247,0,182,0,156,55,542,145,195,0,178,0,11,13,359,116,52,0,4,0,145,42
250250611011,617,251,147,2,73,2,110,32,369,162,116,1,73,2,0,15,248,89,31,1,0,0,110,17
250250611012,1615,559,460,18,240,4,230,104,928,287,351,6,240,0,9,35,687,272,109,12,0,4,221,69
250250612001,1702,1466,47,2,137,0,23,27,1599,1397,32,2,137,0,5,26,103,69,15,0,0,0,18,1
250250612002,627,578,22,0,15,2,5,5,606,564,21,0,15,2,2,2,21,14,1,0,0,0,3,3
250250612003,911,798,19,0,72,1,11,10,879,782,15,0,70,1,3,8,32,16,4,0,2,0,8,2
250250701011,850,669,27,0,125,0,5,24,819,645,27,0,125,0,1,21,31,24,0,0,0,0,4,3
250250701012,303,98,10,0,181,0,12,2,288,96,8,0,181,0,1,2,15,2,2,0,0,0,11,0
250250701013,494,275,26,1,166,0,7,19,464,257,25,1,166,0,1,14,30,18,1,0,0,0,6,5
250250701014,1887,1428,65,1,336,0,17,40,1795,1362,54,1,336,0,5,37,92,66,11,0,0,0,12,3
250250701015,451,271,109,1,38,2,22,8,389,243,100,1,38,1,2,4,62,28,9,0,0,1,20,4
250250701016,366,250,7,0,90,0,9,10,326,219,7,0,90,0,1,9,40,31,0,0,0,0,8,1
250250701017,1102,447,21,0,591,0,8,35,1039,400,21,0,589,0,0,29,63,47,0,0,2,0,8,6
250250701018,449,315,34,0,79,2,10,9,422,302,32,0,79,2,0,7,27,13,2,0,0,0,10,2
250250702001,1460,283,47,0,1088,0,18,24,1412,256,46,0,1085,0,5,20,48,27,1,0,3,0,13,4
250250702002,1133,28,48,1,1035,1,4,16,1125,26,48,1,1035,1,0,14,8,2,0,0,0,0,4,2
250250702003,2625,1518,103,3,918,0,33,50,2521,1467,88,2,918,0,4,42,104,51,15,1,0,0,29,8
250250703001,1065,721,38,2,271,0,8,25,1019,690,38,2,270,0,1,18,46,31,0,0,1,0,7,7
250250703002,733,571,10,1,128,0,8,15,709,553,10,1,128,0,5,12,24,18,0,0,0,0,3,3
250250703003,992,822,33,1,86,1,19,30,932,787,29,1,86,1,7,21,60,35,4,0,0,0,12,9
250250703004,1119,977,29,0,83,0,9,21,1088,953,28,0,83,0,4,20,31,24,1,0,0,0,5,1
250250704021,1723,154,239,2,1206,0,81,41,1565,110,221,2,1206,0,6,20,158,44,18,0,0,0,75,21
250250705001,1700,1275,46,5,281,0,41,52,1595,1230,42,0,281,0,8,34,105,45,4,5,0,0,33,18
250250705002,999,337,159,8,270,0,178,47,537,129,120,2,269,0,3,14,462,208,39,6,1,0,175,33
250250705003,1393,1021,61,2,182,0,84,43,1202,945,47,2,182,0,2,24,191,76,14,0,0,0,82,19
250250705004,1368,789,199,4,205,1,133,37,1056,658,172,0,205,0,4,17,312,131,27,4,0,1,129,20
250250706001,1127,976,30,2,71,0,21,27,1076,941,26,2,71,0,13,23,51,35,4,0,0,0,8,4
250250706002,1113,926,66,1,59,1,28,32,1050,897,65,1,59,1,2,25,63,29,1,0,0,0,26,7
250250707001,1161,575,335,5,161,0,34,51,1050,514,318,5,160,0,11,42,111,61,17,0,1,0,23,9
250250707002,1200,822,251,2,74,0,11,40,1117,773,235,2,74,0,3,30,83,49,16,0,0,0,8,10
250250708001,1594,1021,331,3,114,0,59,66,1416,937,317,1,114,0,8,39,178,84,14,2,0,0,51,27
250250708002,1040,623,282,0,74,0,32,29,943,572,268,0,74,0,5,24,97,51,14,0,0,0,27,5
250250708003,1072,835,117,2,77,0,13,28,1010,798,100,2,76,0,7,27,62,37,17,0,1,0,6,1
250250709001,2166,1325,435,8,191,0,134,73,1830,1171,407,3,191,0,5,53,336,154,28,5,0,0,129,20
250250709002,1163,400,398,8,79,1,196,81,785,311,340,6,79,1,6,42,378,89,58,2,0,0,190,39
250250711011,1498,788,183,5,383,0,92,47,1319,720,172,5,383,0,6,33,179,68,11,0,0,0,86,14
250250711012,1424,1000,221,10,98,1,62,32,1278,936,202,9,98,1,9,23,146,64,19,1,0,0,53,9
250250711013,831,229,239,9,190,0,118,46,643,181,219,3,189,0,23,28,188,48,20,6,1,0,95,18
250250712011,1899,1151,213,8,407,0,62,58,1726,1077,190,7,405,0,5,42,173,74,23,1,2,0,57,16
250250712012,1232,317,453,3,71,4,327,57,647,141,402,0,71,4,13,16,585,176,51,3,0,0,314,41
250250801001,2612,1032,1044,9,31,0,385,111,1867,476,1002,4,31,0,265,89,745,556,42,5,0,0,120,22
250250801002,738,90,493,9,13,0,85,48,541,40,446,2,13,0,18,22,197,50,47,7,0,0,67,26
250250803001,1769,198,1155,19,16,0,290,91,1261,83,1065,11,16,0,45,41,508,115,90,8,0,0,245,50
250250804011,1265,240,692,6,50,0,207,70,852,143,604,5,49,0,14,37,413,97,88,1,1,0,193,33
250250804012,1445,248,844,22,17,0,176,138,874,57,745,11,17,0,1,43,571,191,99,11,0,0,175,95
250250805001,1076,271,578,6,51,0,115,55,729,179,476,0,51,0,6,17,347,92,102,6,0,0,109,38
250250805002,2020,375,1095,5,50,3,379,113,1038,54,893,2,48,1,7,33,982,321,202,3,2,2,372,80
250250806011,3212,2228,363,12,367,0,152,90,2899,2102,332,10,366,0,30,59,313,126,31,2,1,0,122,31
250250806012,600,82,298,4,13,0,164,39,297,11,254,0,13,0,3,16,303,71,44,4,0,0,161,23
250250806013,459,59,292,2,6,0,73,27,332,33,264,2,6,0,12,15,127,26,28,0,0,0,61,12
250250808011,2219,1359,342,24,122,0,267,105,1585,1119,282,8,118,0,4,54,634,240,60,16,4,0,263,51
250250808012,1666,349,604,20,268,0,347,78,955,139,509,11,268,0,8,20,711,210,95,9,0,0,339,58
250250809001,1411,810,127,5,405,0,22,42,1329,762,123,3,405,0,4,32,82,48,4,2,0,0,18,10
250250809002,1518,1135,158,4,100,1,64,56,1340,1071,134,2,100,1,3,29,178,64,24,2,0,0,61,27
250250809003,1079,803,75,1,155,3,11,31,1026,768,72,0,155,3,1,27,53,35,3,1,0,0,10,4
250250810011,515,219,99,9,139,0,29,20,439,195,85,2,139,0,3,15,76,24,14,7,0,0,26,5
250250810012,2365,894,452,11,575,2,313,118,1666,658,371,5,566,2,6,58,699,236,81,6,9,0,307,60
250250810013,787,637,65,11,46,0,15,13,748,613,63,9,46,0,4,13,39,24,2,2,0,0,11,0
250250810014,1223,762,183,4,169,1,45,59,1087,714,165,3,169,1,1,34,136,48,18,1,0,0,44,25
250250811001,1467,782,384,8,114,0,117,62,1161,651,347,3,112,0,8,40,306,131,37,5,2,0,109,22
250250811002,1643,806,338,2,381,1,62,53,1426,713,304,2,377,1,3,26,217,93,34,0,4,0,59,27
250250811003,981,643,229,1,60,1,21,26,896,589,225,1,60,0,4,17,85,54,4,0,0,1,17,9
250250812001,2130,417,953,27,42,0,523,168,944,36,813,3,40,0,13,39,1186,381,140,24,2,0,510,129
250250812002,1135,540,219,12,43,0,220,101,601,357,149,0,43,0,4,48,534,183,70,12,0,0,216,53
250250813001,1661,355,760,11,13,0,388,134,788,87,631,6,13,0,12,39,873,268,129,5,0,0,376,95
250250813002,1749,279,1006,32,12,5,314,101,1062,92,904,7,12,5,6,36,687,187,102,25,0,0,308,65
250250813003,1350,303,584,17,20,0,323,103,649,120,477,9,14,0,9,20,701,183,107,8,6,0,314,83
250250814001,1067,189,687,22,21,0,99,49,836,141,627,7,20,0,7,34,231,48,60,15,1,0,92,15
250250814002,772,169,456,6,19,0,84,38,615,129,433,2,19,0,7,25,157,40,23,4,0,0,77,13
250250814003,1164,472,505,9,53,0,73,52,966,415,456,9,53,0,4,29,198,57,49,0,0,0,69,23
250250815001,788,140,555,3,13,0,39,38,697,93,541,3,13,0,17,30,91,47,14,0,0,0,22,8
250250815002,1346,196,891,9,12,2,168,68,921,84,788,6,12,2,8,21,425,112,103,3,0,0,160,47
250250817001,619,22,575,2,1,0,5,14,581,6,556,2,1,0,3,13,38,16,19,0,0,0,2,1
250250817002,893,30,730,5,21,1,65,41,760,17,697,3,16,1,9,17,133,13,33,2,5,0,56,24
250250817003,780,82,540,9,2,0,107,40,538,11,500,5,2,0,0,20,242,71,40,4,0,0,107,20
250250817004,887,87,570,12,32,0,109,77,652,21,523,4,32,0,19,53,235,66,47,8,0,0,90,24
250250817005,641,41,475,6,7,0,81,31,507,19,449,4,7,0,6,22,134,22,26,2,0,0,75,9
250250818001,1157,109,797,7,31,0,130,83,845,35,736,6,30,0,2,36,312,74,61,1,1,0,128,47
250250818002,921,61,651,3,2,0,151,53,706,34,600,1,2,0,33,36,215,27,51,2,0,0,118,17
250250818003,820,46,583,6,7,4,120,54,611,9,543,6,7,4,16,26,209,37,40,0,0,0,104,28
250250819001,906,49,735,4,9,0,64,45,775,18,695,4,9,0,19,30,131,31,40,0,0,0,45,15
250250819002,617,71,379,7,6,0,114,40,389,15,340,5,6,0,13,10,228,56,39,2,0,0,101,30
250250819003,600,50,423,1,1,0,88,37,450,17,403,1,1,0,7,21,150,33,20,0,0,0,81,16
250250819004,992,93,678,9,2,0,155,55,673,18,608,6,2,0,6,33,319,75,70,3,0,0,149,22
250250820001,1292,69,1051,14,10,0,95,53,1060,24,980,4,10,0,15,27,232,45,71,10,0,0,80,26
250250820002,682,38,530,5,9,1,81,18,580,18,519,5,9,1,17,11,102,20,11,0,0,0,64,7
250250820003,841,65,612,1,0,0,114,49,641,10,588,0,0,0,15,28,200,55,24,1,0,0,99,21
250250821001,1228,77,799,16,7,0,268,61,793,13,714,7,7,0,24,28,435,64,85,9,0,0,244,33
250250821002,1553,95,984,11,15,0,347,101,1007,13,927,4,14,0,12,37,546,82,57,7,1,0,335,64
250250821003,2244,228,1572,16,12,1,312,103,1564,36,1452,10,11,1,8,46,680,192,120,6,1,0,304,57
250250901001,1631,92,1084,28,24,0,300,103,1108,19,988,21,24,0,10,46,523,73,96,7,0,0,290,57
250250901002,531,27,439,1,0,1,49,14,435,11,415,1,0,0,1,7,96,16,24,0,0,1,48,7
250250901003,693,28,575,5,1,1,58,25,575,15,524,4,1,1,12,18,118,13,51,1,0,0,46,7
250250901004,1099,57,858,5,3,0,114,62,892,25,807,2,1,0,24,33,207,32,51,3,2,0,90,29
250250901005,617,48,531,0,4,0,15,19,532,16,497,0,4,0,4,11,85,32,34,0,0,0,11,8
250250902001,673,73,391,7,26,0,148,28,423,15,354,1,26,0,18,9,250,58,37,6,0,0,130,19
250250902002,626,51,380,9,8,0,148,30,380,11,336,2,8,0,9,14,246,40,44,7,0,0,139,16
250250902003,934,100,513,3,11,4,238,65,565,14,486,2,11,0,26,26,369,86,27,1,0,4,212,39
250250903001,891,105,514,7,2,2,219,42,539,20,460,5,2,1,32,19,352,85,54,2,0,1,187,23
250250903002,1310,139,850,12,16,0,223,70,868,14,771,2,12,0,36,33,442,125,79,10,4,0,187,37
250250903003,978,73,683,1,10,0,146,65,690,13,623,1,5,0,5,43,288,60,60,0,5,0,141,22
250250904001,871,109,523,16,3,2,130,88,559,24,463,9,3,2,25,33,312,85,60,7,0,0,105,55
250250904002,1155,92,738,5,11,0,210,99,788,21,660,5,11,0,38,53,367,71,78,0,0,0,172,46
250250904003,763,99,451,4,14,0,161,34,524,26,397,4,12,0,65,20,239,73,54,0,2,0,96,14
250250904004,870,88,443,18,8,1,212,100,583,18,380,0,6,0,108,71,287,70,63,18,2,1,104,29
250250906001,1094,121,608,11,8,3,220,123,799,42,553,4,8,3,102,87,295,79,55,7,0,0,118,36
250250906002,1254,112,409,5,28,0,579,121,1057,51,363,4,28,0,503,108,197,61,46,1,0,0,76,13
250250907001,1218,678,106,0,356,0,45,33,1137,639,99,0,356,0,12,31,81,39,7,0,0,0,33,2
250250907002,1253,964,84,6,130,0,42,27,1187,940,82,6,130,0,7,22,66,24,2,0,0,0,35,5
250250907003,1153,631,157,8,194,0,113,50,1009,584,144,4,194,0,47,36,144,47,13,4,0,0,66,14
250250907004,651,474,47,0,67,0,49,14,563,434,45,0,67,0,6,11,88,40,2,0,0,0,43,3
250250909011,1627,634,412,15,281,1,204,80,1187,486,346,6,281,1,32,35,440,148,66,9,0,0,172,45
250250909012,2103,1040,348,5,461,4,190,55,1775,914,313,4,461,4,30,49,328,126,35,1,0,0,160,6
250250910011,650,131,172,0,218,0,82,47,565,121,168,0,218,0,19,39,85,10,4,0,0,0,63,8
250250910012,743,367,88,1,200,0,54,33,658,341,80,0,200,0,13,24,85,26,8,1,0,0,41,9
250250910013,682,614,20,0,33,1,4,10,659,599,16,0,33,1,0,10,23,15,4,0,0,0,4,0
250250910014,667,551,36,0,66,1,3,10,648,538,34,0,66,1,0,9,19,13,2,0,0,0,3,1
250250911001,1395,826,180,2,230,0,97,60,1233,751,173,2,230,0,29,48,162,75,7,0,0,0,68,12
250250911002,1007,619,102,0,180,0,46,60,951,599,101,0,180,0,18,53,56,20,1,0,0,0,28,7
250250911003,929,369,107,0,395,0,40,18,889,348,103,0,395,0,26,17,40,21,4,0,0,0,14,1
250250911004,713,262,120,8,211,5,68,39,619,237,101,8,211,0,28,34,94,25,19,0,0,5,40,5
250250911005,817,367,138,6,201,4,69,32,703,325,119,6,199,0,29,25,114,42,19,0,2,4,40,7
250250912001,1081,519,201,5,87,1,195,73,870,428,173,4,87,1,125,52,211,91,28,1,0,0,70,21
250250912002,1411,443,416,3,102,3,330,114,1102,375,371,0,101,3,172,80,309,68,45,3,1,0,158,34
250250912003,742,199,241,3,9,2,200,88,565,178,218,1,8,1,93,66,177,21,23,2,1,1,107,22
250250913001,1368,198,415,8,49,1,547,150,1085,127,399,4,49,1,385,120,283,71,16,4,0,0,162,30
250250913002,1131,118,511,4,34,1,353,110,882,38,470,2,32,0,259,81,249,80,41,2,2,1,94,29
250250914001,1672,260,811,8,19,1,426,147,1207,129,738,4,18,1,203,114,465,131,73,4,1,0,223,33
250250914002,1069,153,562,3,8,0,250,93,732,67,529,2,8,0,59,67,337,86,33,1,0,0,191,26
250250915001,1978,398,770,9,84,0,559,158,1545,291,724,7,84,0,318,121,433,107,46,2,0,0,241,37
250250915002,1494,121,766,2,52,1,387,165,1158,49,690,1,52,0,236,130,336,72,76,1,0,1,151,35
250250915003,898,107,352,0,67,0,263,109,750,67,321,0,66,0,195,101,148,40,31,0,1,0,68,8
250250916001,1205,207,581,1,44,0,267,105,1029,190,553,1,39,0,152,94,176,17,28,0,5,0,115,11
250250916002,1273,172,343,5,475,0,195,83,1040,103,314,5,475,0,91,52,233,69,29,0,0,0,104,31
250250916003,660,110,155,3,294,0,64,34,583,92,148,3,291,0,20,29,77,18,7,0,3,0,44,5
250250917001,1306,190,598,7,66,0,301,144,1023,124,555,2,66,0,176,100,283,66,43,5,0,0,125,44
250250917002,988,81,515,5,2,0,290,95,780,41,451,4,2,0,208,74,208,40,64,1,0,0,82,21
250250917003,775,83,482,14,59,0,99,38,634,35,434,4,59,0,72,30,141,48,48,10,0,0,27,8
250250918001,1517,166,761,8,48,0,430,104,1143,74,683,8,47,0,247,84,374,92,78,0,1,0,183,20
250250918002,1002,64,548,7,7,0,302,74,821,30,508,4,7,0,202,70,181,34,40,3,0,0,100,4
250250918003,933,64,638,2,5,0,158,66,775,28,607,2,5,0,75,58,158,36,31,0,0,0,83,8
250250919001,1042,75,802,5,1,0,101,58,812,21,735,5,1,0,17,33,230,54,67,0,0,0,84,25
250250919002,709,34,561,2,4,0,69,39,589,17,516,2,4,0,24,26,120,17,45,0,0,0,45,13
250250919003,1522,88,1152,15,7,0,174,86,1200,29,1065,8,7,0,45,46,322,59,87,7,0,0,129,40
250250919004,587,84,402,13,0,0,73,15,435,27,383,2,0,0,11,12,152,57,19,11,0,0,62,3
250250920001,1374,156,680,5,230,5,211,87,1090,91,651,5,229,4,59,51,284,65,29,0,1,1,152,36
250250920002,1750,169,1043,8,172,5,229,124,1401,100,940,2,170,0,90,99,349,69,103,6,2,5,139,25
250250920003,881,109,548,3,19,0,121,81,653,31,523,3,19,0,24,53,228,78,25,0,0,0,97,28
250250920004,940,80,614,1,49,0,126,70,750,36,562,1,49,0,47,55,190,44,52,0,0,0,79,15
250250921011,1113,586,176,7,183,0,109,52,951,540,153,1,183,0,35,39,162,46,23,6,0,0,74,13
250250921012,1105,197,224,3,568,3,69,41,1009,169,214,2,562,3,22,37,96,28,10,1,6,0,47,4
250250921013,729,485,52,1,157,0,21,13,669,449,49,1,157,0,3,10,60,36,3,0,0,0,18,3
250250921014,1008,313,241,2,373,0,45,34,909,281,226,1,371,0,15,15,99,32,15,1,2,0,30,19
250250921015,2496,539,800,12,764,0,236,145,2224,467,771,5,753,0,106,122,272,72,29,7,11,0,130,23
250250922001,911,265,372,3,171,0,67,33,782,221,343,3,171,0,17,27,129,44,29,0,0,0,50,6
250250922002,776,206,220,4,260,0,50,36,727,190,207,4,260,0,33,33,49,16,13,0,0,0,17,3
250250922003,748,186,429,8,57,0,39,29,679,162,409,7,57,0,19,25,69,24,20,1,0,0,20,4
250250922004,914,202,480,1,54,0,106,71,739,167,458,1,54,0,21,38,175,35,22,0,0,0,85,33
250250923001,787,51,594,4,3,0,81,54,664,23,576,1,3,0,18,43,123,28,18,3,0,0,63,11
250250923002,671,32,531,3,15,0,71,19,548,10,506,2,15,0,4,11,123,22,25,1,0,0,67,8
250250923003,861,36,725,1,2,0,63,34,741,7,689,1,2,0,18,24,120,29,36,0,0,0,45,10
250250923004,574,41,464,1,1,0,27,40,482,7,451,1,1,0,1,21,92,34,13,0,0,0,26,19
250250924001,637,30,531,4,0,0,44,28,543,9,505,3,0,0,4,22,94,21,26,1,0,0,40,6
250250924002,1089,79,805,21,7,0,100,77,866,19,755,16,7,0,15,54,223,60,50,5,0,0,85,23
250250924003,1688,136,1277,5,15,0,182,73,1251,15,1172,5,11,0,14,34,437,121,105,0,4,0,168,39
250250924004,1142,150,581,18,16,0,291,86,539,11,472,7,16,0,9,24,603,139,109,11,0,0,282,62
250250924005,721,15,596,4,9,0,68,29,608,2,566,1,9,0,18,12,113,13,30,3,0,0,50,17
250251001001,167,7,102,0,6,0,38,14,114,7,86,0,6,0,6,9,53,0,16,0,0,0,32,5
250251001002,643,30,503,4,0,2,79,25,484,0,448,4,0,2,17,13,159,30,55,0,0,0,62,12
250251001003,821,26,673,0,3,0,95,24,666,1,623,0,3,0,31,8,155,25,50,0,0,0,64,16
250251001004,964,45,747,4,6,0,107,55,750,8,686,2,6,0,18,30,214,37,61,2,0,0,89,25
250251001005,622,34,554,1,3,0,20,10,561,14,534,1,3,0,3,6,61,20,20,0,0,0,17,4
250251001006,1320,164,766,13,24,2,276,75,751,15,666,8,19,2,8,33,569,149,100,5,5,0,268,42
250251001007,973,149,565,3,11,0,194,51,581,12,499,2,11,0,29,28,392,137,66,1,0,0,165,23
250251002001,987,33,844,2,2,0,74,32,870,13,814,0,2,0,16,25,117,20,30,2,0,0,58,7
250251002002,719,26,583,7,4,0,58,41,585,1,539,3,4,0,8,30,134,25,44,4,0,0,50,11
250251002003,1081,45,892,5,21,0,76,42,919,23,832,1,21,0,25,17,162,22,60,4,0,0,51,25
250251003001,983,54,796,6,11,0,57,59,889,44,766,5,11,0,24,39,94,10,30,1,0,0,33,20
250251003002,877,45,746,0,0,0,58,28,788,31,723,0,0,0,16,18,89,14,23,0,0,0,42,10
250251003003,731,58,591,0,11,0,44,27,630,26,557,0,11,0,16,20,101,32,34,0,0,0,28,7
250251003004,712,23,617,2,1,0,44,25,644,19,597,2,1,0,9,16,68,4,20,0,0,0,35,9
250251004001,1283,174,900,1,61,0,90,57,1145,142,859,1,61,0,46,36,138,32,41,0,0,0,44,21
250251004002,1061,288,500,8,121,0,72,72,963,268,478,8,119,0,37,53,98,20,22,0,2,0,35,19
250251004003,798,80,630,4,39,0,20,25,754,77,612,4,39,0,2,20,44,3,18,0,0,0,18,5
250251004004,1723,106,1431,8,14,0,87,77,1546,70,1371,6,14,0,25,60,177,36,60,2,0,0,62,17
250251005001,1220,207,521,8,353,0,81,50,1111,179,496,3,353,0,36,44,109,28,25,5,0,0,45,6
250251005002,994,451,376,3,69,0,56,39,885,397,362,3,69,0,23,31,109,54,14,0,0,0,33,8
250251005003,1259,194,733,2,117,1,127,85,1045,143,690,1,117,0,32,62,214,51,43,1,0,1,95,23
250251005004,1328,75,1026,15,18,1,116,77,1074,33,965,3,18,1,11,43,254,42,61,12,0,0,105,34
250251005005,1188,113,889,12,15,0,109,50,906,44,804,4,15,0,13,26,282,69,85,8,0,0,96,24
250251006011,1094,824,183,2,51,2,24,8,1039,801,168,2,51,2,7,8,55,23,15,0,0,0,17,0
250250203021,1181,1060,31,2,60,0,12,16,1120,1011,31,1,60,0,3,14,61,49,0,1,0,0,9,2
250250203031,878,721,19,1,110,0,4,23,819,667,19,1,110,0,2,20,59,54,0,0,0,0,2,3
250250203032,1343,781,468,5,65,1,10,13,1111,567,461,5,65,1,1,11,232,214,7,0,0,0,9,2
250250203033,1179,862,88,0,156,0,29,44,1097,813,84,0,154,0,5,41,82,49,4,0,2,0,24,3
250250301001,1053,1001,12,0,15,1,17,7,1013,976,11,0,14,1,5,6,40,25,1,0,1,0,12,1
250250301002,901,867,8,0,16,1,3,6,873,842,8,0,16,1,0,6,28,25,0,0,0,0,3,0
250250302001,1665,1580,8,7,37,1,10,22,1596,1523,8,6,36,1,6,16,69,57,0,1,1,0,4,6
250250303001,1757,1579,39,5,79,0,23,32,1682,1533,36,3,79,0,4,27,75,46,3,2,0,0,19,5
250250303002,1262,1094,91,4,36,0,17,20,1199,1050,90,4,36,0,3,16,63,44,1,0,0,0,14,4
250250303003,1305,1055,122,5,71,1,23,28,1234,1017,112,5,71,1,4,24,71,38,10,0,0,0,19,4
250250303004,548,413,13,0,100,0,11,11,518,388,12,0,100,0,7,11,30,25,1,0,0,0,4,0
250250304001,1519,1440,6,4,45,0,8,16,1474,1405,6,3,45,0,0,15,45,35,0,1,0,0,8,1
250250304002,932,871,8,2,29,0,14,8,899,848,7,2,29,0,6,7,33,23,1,0,0,0,8,1
250250305001,704,646,9,0,40,0,5,4,680,628,6,0,40,0,2,4,24,18,3,0,0,0,3,0
250250305002,1025,963,4,0,31,0,10,17,988,937,4,0,30,0,2,15,37,26,0,0,1,0,8,2
250250305003,809,753,3,0,37,0,11,5,777,729,3,0,37,0,3,5,32,24,0,0,0,0,8,0
250250401001,958,908,8,2,27,0,7,6,938,895,7,2,27,0,1,6,20,13,1,0,0,0,6,0
250250401002,1210,1169,4,1,19,0,6,11,1189,1157,4,0,19,0,0,9,21,12,0,1,0,0,6,2
250250402001,775,243,261,5,94,0,141,31,450,110,211,2,94,0,14,19,325,133,50,3,0,0,127,12
250250402002,831,765,17,0,36,0,5,8,805,751,13,0,36,0,1,4,26,14,4,0,0,0,4,4
250250403001,739,276,171,7,99,0,135,51,405,176,129,0,98,0,0,2,334,100,42,7,1,0,135,49
250250403002,1247,1183,8,1,26,0,4,25,1222,1169,5,1,25,0,0,22,25,14,3,0,1,0,4,3
250250403003,657,637,2,0,10,0,0,8,650,631,2,0,10,0,0,7,7,6,0,0,0,0,0,1
250250403004,617,597,1,0,11,1,1,6,608,592,1,0,10,0,1,4,9,5,0,0,1,1,0,2
250250403005,622,608,1,0,3,0,2,8,613,601,1,0,3,0,0,8,9,7,0,0,0,0,2,0
250250404011,1689,1358,65,5,178,0,42,41,1563,1302,49,4,177,0,5,26,126,56,16,1,1,0,37,15
250250404012,750,712,2,0,26,1,5,4,732,700,1,0,26,1,0,4,18,12,1,0,0,0,5,0
250250406001,863,758,32,0,56,0,6,11,839,737,30,0,56,0,5,11,24,21,2,0,0,0,1,0
250250406002,1581,1526,6,0,33,1,3,12,1547,1498,6,0,33,1,0,9,34,28,0,0,0,0,3,3
250250408011,1061,310,317,8,147,6,200,73,616,136,261,3,146,6,31,33,445,174,56,5,1,0,169,40
250250408012,828,272,31,5,477,0,26,17,739,223,22,5,477,0,0,12,89,49,9,0,0,0,26,5
250250408013,2011,1842,23,1,97,2,13,33,1932,1780,22,1,97,2,4,26,79,62,1,0,0,0,9,7
250250501011,1713,945,44,12,83,0,517,112,576,442,19,3,82,0,6,24,1137,503,25,9,1,0,511,88
250250501012,1472,812,99,3,148,0,314,96,663,401,64,2,148,0,5,43,809,411,35,1,0,0,309,53
250250501013,1930,1227,65,16,62,0,464,96,736,585,49,6,57,0,18,21,1194,642,16,10,5,0,446,75
250250502001,2189,1233,115,12,64,0,611,154,731,513,80,6,64,0,34,34,1458,720,35,6,0,0,577,120
250250502002,1151,677,45,1,16,1,337,74,443,365,24,1,16,0,17,20,708,312,21,0,0,1,320,54
250250502003,836,437,23,2,26,0,290,58,269,191,16,1,26,0,21,14,567,246,7,1,0,0,269,44
250250502004,1055,666,17,7,23,1,280,61,361,284,15,0,23,1,24,14,694,382,2,7,0,0,256,47
250250503001,727,363,52,8,18,0,238,48,274,181,43,3,17,0,22,8,453,182,9,5,1,0,216,40
250250503002,1524,703,260,7,219,0,226,109,949,469,188,1,219,0,18,54,575,234,72,6,0,0,208,55
250250504001,637,349,28,6,27,0,187,40,268,171,23,5,26,0,27,16,369,178,5,1,1,0,160,24
250250504002,1735,1290,62,3,40,0,271,69,900,764,43,0,37,0,25,31,835,526,19,3,3,0,246,38
250250505001,1857,1309,60,0,50,0,341,97,861,710,29,0,48,0,43,31,996,599,31,0,2,0,298,66
250250506001,1248,802,19,7,36,1,308,75,461,370,13,5,35,0,19,19,787,432,6,2,1,1,289,56
250250506002,815,476,38,1,10,0,214,76,228,153,27,0,10,0,25,13,587,323,11,1,0,0,189,63
250250507001,1684,924,52,8,39,0,589,72,579,438,38,1,39,0,48,15,1105,486,14,7,0,0,541,57
250250507002,1344,742,29,21,34,0,437,81,518,394,19,4,32,0,54,15,826,348,10,17,2,0,383,66
250250507003,1476,785,43,5,15,7,545,76,501,393,25,0,15,0,52,16,975,392,18,5,0,7,493,60
250250509011,1283,888,17,11,44,0,273,50,411,340,13,2,41,0,13,2,872,548,4,9,3,0,260,48
250250509012,1964,1297,66,7,31,0,472,91,730,612,45,1,29,0,21,22,1234,685,21,6,2,0,451,69
250250509013,918,587,16,1,18,0,236,60,320,263,12,0,16,0,16,13,598,324,4,1,2,0,220,47
250250510001,2039,1609,51,13,46,0,245,75,1264,1132,42,6,42,0,13,29,775,477,9,7,4,0,232,46
250250510002,962,673,80,7,65,0,120,17,622,494,49,0,65,0,4,10,340,179,31,7,0,0,116,7
250250510003,1088,853,10,6,14,2,170,33,631,590,7,1,14,1,10,8,457,263,3,5,0,1,160,25
250250511011,1602,1214,52,8,34,0,253,41,885,783,39,5,34,0,11,13,717,431,13,3,0,0,242,28
250250511012,1949,1109,311,18,114,0,279,118,1115,691,250,2,110,0,27,35,834,418,61,16,4,0,252,83
250250511013,1537,1240,22,6,44,0,170,55,1105,987,14,5,44,0,31,24,432,253,8,1,0,0,139,31
250250511014,1005,862,35,3,41,1,37,26,813,728,25,1,40,1,1,17,192,134,10,2,1,0,36,9
250250512001,32,25,1,0,1,0,3,2,30,25,1,0,1,0,3,0,2,0,0,0,0,0,0,2
250250512002,1548,1186,51,7,36,1,206,61,887,758,36,3,31,0,30,29,661,428,15,4,5,1,176,32
250250512003,799,645,36,1,20,4,68,25,640,566,22,1,20,0,17,14,159,79,14,0,0,4,51,11
250250601011,881,866,2,1,6,2,0,4,870,858,1,1,6,1,0,3,11,8,1,0,0,1,0,1
250250601012,633,628,0,0,1,0,2,2,624,621,0,0,1,0,0,2,9,7,0,0,0,0,2,0
250250601013,981,969,2,0,2,0,5,3,964,957,1,0,2,0,1,3,17,12,1,0,0,0,4,0
250250601014,721,683,16,3,5,0,3,11,714,679,16,3,5,0,0,11,7,4,0,0,0,0,3,0
250250602001,821,808,2,0,5,0,1,5,817,806,2,0,4,0,0,5,4,2,0,0,1,0,1,0
250250602002,1095,1086,1,0,3,0,1,4,1086,1078,1,0,3,0,0,4,9,8,0,0,0,0,1,0
250250603011,1285,1239,13,1,13,0,5,14,1275,1233,12,1,13,0,4,12,10,6,1,0,0,0,1,2
250250603012,699,686,2,0,9,0,1,1,696,684,2,0,9,0,0,1,3,2,0,0,0,0,1,0
250250603013,1092,1061,7,0,6,0,7,11,1077,1052,6,0,6,0,4,9,15,9,1,0,0,0,3,2
250235116004,624,359,161,2,25,0,53,24,556,314,155,2,25,0,40,20,68,45,6,0,0,0,13,4
250235116005,928,582,235,0,24,0,60,27,845,551,215,0,22,0,37,20,83,31,20,0,2,0,23,7
250235116006,1887,667,703,4,41,0,341,131,1681,613,682,2,38,0,231,115,206,54,21,2,3,0,110,16
250235116007,599,462,99,1,10,0,18,9,570,452,91,1,10,0,9,7,29,10,8,0,0,0,9,2
250235117011,690,464,129,0,18,1,49,29,633,443,118,0,18,1,26,27,57,21,11,0,0,0,23,2
250235117012,1495,1109,207,2,53,0,79,45,1398,1062,204,2,53,0,44,33,97,47,3,0,0,0,35,12
250235117013,817,577,143,0,34,0,41,22,749,558,124,0,34,0,22,11,68,19,19,0,0,0,19,11
250235117014,906,473,279,0,20,0,74,60,853,448,276,0,20,0,58,51,53,25,3,0,0,0,16,9
250235117015,747,532,126,2,34,0,22,31,698,500,124,2,32,0,11,29,49,32,2,0,2,0,11,2
250235117021,1608,1149,242,10,71,3,77,56,1520,1108,223,9,70,3,57,50,88,41,19,1,1,0,20,6
250235117022,1190,899,154,1,55,0,38,43,1137,860,149,1,55,0,33,39,53,39,5,0,0,0,5,4
250235201001,1912,1805,15,1,32,0,42,17,1880,1782,15,1,31,0,36,15,32,23,0,0,1,0,6,2
250235201002,1046,978,23,11,6,0,7,21,1027,964,19,11,6,0,7,20,19,14,4,0,0,0,0,1
250235201003,1979,1856,38,8,28,1,17,31,1949,1841,37,7,28,1,9,26,30,15,1,1,0,0,8,5
250235201004,1521,1416,39,5,19,1,19,22,1500,1399,39,5,19,1,19,18,21,17,0,0,0,0,0,4
250235202011,797,761,10,2,11,0,10,3,778,751,8,2,11,0,3,3,19,10,2,0,0,0,7,0
250235202012,1445,1280,20,6,14,0,110,15,1410,1273,18,1,14,0,92,12,35,7,2,5,0,0,18,3
250235202013,1710,1602,18,2,32,0,32,24,1686,1594,15,2,32,0,19,24,24,8,3,0,0,0,13,0
250235202021,1035,931,50,3,18,0,14,19,1007,916,45,3,18,0,10,15,28,15,5,0,0,0,4,4
250235202022,2031,1898,51,8,46,0,15,13,1998,1875,48,8,46,0,8,13,33,23,3,0,0,0,7,0
250235202023,2509,2261,78,1,78,0,37,54,2440,2222,69,1,77,0,23,48,69,39,9,0,1,0,14,6
250235211011,749,719,5,0,0,0,6,19,737,708,5,0,0,0,6,18,12,11,0,0,0,0,0,1
250235211012,705,652,19,5,2,3,14,10,692,645,19,5,2,3,8,10,13,7,0,0,0,0,6,0
250235211013,1839,1752,18,2,31,1,21,14,1801,1730,15,2,31,1,12,10,38,22,3,0,0,0,9,4
250235211014,1010,954,14,6,13,0,5,18,993,943,14,6,13,0,2,15,17,11,0,0,0,0,3,3
250235211021,1481,1393,13,3,12,1,24,35,1454,1376,13,3,12,1,17,32,27,17,0,0,0,0,7,3
250235211022,1835,1745,25,2,19,0,9,35,1792,1718,25,2,19,0,0,28,43,27,0,0,0,0,9,7
250235212011,990,959,1,3,5,0,12,10,969,948,1,3,5,0,2,10,21,11,0,0,0,0,10,0
250235212012,1105,1054,20,1,4,0,13,13,1072,1025,20,1,4,0,9,13,33,29,0,0,0,0,4,0
250235212013,809,752,17,0,2,0,12,26,794,748,16,0,2,0,8,20,15,4,1,0,0,0,4,6
250235212021,1271,1204,16,6,10,0,15,20,1248,1194,16,4,7,0,13,14,23,10,0,2,3,0,2,6
250235212022,889,857,8,1,4,0,11,8,885,853,8,1,4,0,11,8,4,4,0,0,0,0,0,0
250235212023,965,918,11,2,8,0,6,20,956,912,11,2,8,0,5,18,9,6,0,0,0,0,1,2
250235212024,841,809,13,4,1,0,2,12,829,803,13,3,1,0,0,9,12,6,0,1,0,0,2,3
250235221011,883,866,9,0,2,0,2,4,875,860,9,0,2,0,2,2,8,6,0,0,0,0,0,2
250235221012,1744,1623,41,1,6,0,28,45,1729,1613,39,1,6,0,26,44,15,10,2,0,0,0,2,1
250235221013,2118,2060,10,1,15,0,11,21,2092,2041,6,1,15,0,9,20,26,19,4,0,0,0,2,1
250235221021,1111,1072,19,0,8,0,0,12,1103,1066,18,0,8,0,0,11,8,6,1,0,0,0,0,1
250235221022,1310,1275,11,1,1,0,6,16,1296,1264,11,0,1,0,4,16,14,11,0,1,0,0,2,0
250235221023,1084,1063,2,0,6,0,3,10,1078,1060,2,0,6,0,0,10,6,3,0,0,0,0,3,0
250235221024,1208,1189,2,0,3,0,5,9,1197,1182,1,0,3,0,2,9,11,7,1,0,0,0,3,0
250235221025,751,702,10,0,7,1,8,23,744,699,10,0,7,1,6,21,7,3,0,0,0,0,2,2
250235231001,2069,1930,31,11,26,0,22,49,2023,1908,28,11,26,0,15,35,46,22,3,0,0,0,7,14
250235231002,975,919,11,0,16,0,7,22,964,912,11,0,16,0,5,20,11,7,0,0,0,0,2,2
250235232011,1335,1258,34,2,3,0,18,20,1320,1251,34,2,3,0,11,19,15,7,0,0,0,0,7,1
250235232012,780,738,9,3,3,0,14,13,778,737,9,3,3,0,14,12,2,1,0,0,0,0,0,1
250235232013,782,727,22,1,14,0,0,18,773,719,22,0,14,0,0,18,9,8,0,1,0,0,0,0
250235232021,2016,1965,15,0,10,0,6,20,1979,1938,14,0,10,0,1,16,37,27,1,0,0,0,5,4
250235232022,1481,1401,39,1,6,0,13,21,1461,1389,39,1,6,0,6,20,20,12,0,0,0,0,7,1
250235232023,1635,1575,27,3,7,0,7,16,1609,1556,27,2,7,0,4,13,26,19,0,1,0,0,3,3
250235232024,2721,2626,28,7,32,0,6,22,2683,2594,25,6,32,0,6,20,38,32,3,1,0,0,0,2
250235241011,617,579,13,0,10,0,6,9,596,559,13,0,10,0,6,8,21,20,0,0,0,0,0,1
250235241012,1567,1509,10,0,9,0,14,25,1539,1489,10,0,9,0,10,21,28,20,0,0,0,0,4,4
250235241013,851,790,23,0,18,0,8,12,837,781,23,0,18,0,3,12,14,9,0,0,0,0,5,0
250235241021,1481,1415,9,4,14,0,22,17,1462,1405,7,4,14,0,15,17,19,10,2,0,0,0,7,0
250235241022,1348,1261,32,0,19,0,13,23,1318,1239,31,0,19,0,7,22,30,22,1,0,0,0,6,1
250235241023,1052,1010,17,3,5,0,4,13,1043,1003,17,3,5,0,2,13,9,7,0,0,0,0,2,0
250235251011,1893,1773,45,8,41,0,10,16,1862,1756,38,6,41,0,5,16,31,17,7,2,0,0,5,0
250235251012,998,933,19,4,10,0,18,14,984,927,19,1,10,0,15,12,14,6,0,3,0,0,3,2
250235251013,1051,988,12,0,14,0,12,25,1042,983,12,0,14,0,8,25,9,5,0,0,0,0,4,0
250235251014,2363,2119,93,4,58,0,36,53,2268,2068,85,4,58,0,11,42,95,51,8,0,0,0,25,11
250235251041,2084,1971,59,3,20,0,13,18,2066,1957,59,3,20,0,10,17,18,14,0,0,0,0,3,1
250235251042,1120,1062,26,1,10,0,5,16,1104,1051,26,1,10,0,4,12,16,11,0,0,0,0,1,4
250235251043,907,832,36,0,11,0,8,20,882,816,33,0,11,0,3,19,25,16,3,0,0,0,5,1
250235251044,2178,2090,39,4,14,0,6,25,2167,2082,39,4,14,0,5,23,11,8,0,0,0,0,1,2
250235252031,1540,1446,27,1,27,0,16,23,1504,1423,25,1,26,0,9,20,36,23,2,0,1,0,7,3
250235252032,2423,2358,34,2,12,0,2,15,2414,2349,34,2,12,0,2,15,9,9,0,0,0,0,0,0
250235252033,1632,1415,130,2,21,0,20,44,1578,1375,128,2,21,0,13,39,54,40,2,0,0,0,7,5
250235252041,2266,2144,49,4,13,0,17,39,2224,2117,48,4,13,0,6,36,42,27,1,0,0,0,11,3
250235252042,1116,1026,42,1,16,0,8,23,1103,1019,36,1,16,0,8,23,13,7,6,0,0,0,0,0
250235253001,2063,1387,553,25,16,0,69,13,1717,1136,533,23,16,0,4,5,346,251,20,2,0,0,65,8
250235261001,1576,1536,6,0,8,0,8,18,1558,1527,6,0,8,0,4,13,18,9,0,0,0,0,4,5
250235261002,749,725,5,0,0,0,2,17,737,721,5,0,0,0,2,9,12,4,0,0,0,0,0,8
250235261003,1999,1929,14,2,18,0,12,24,1977,1910,14,2,18,0,9,24,22,19,0,0,0,0,3,0
250235261004,1436,1407,11,0,2,0,2,14,1428,1399,11,0,2,0,2,14,8,8,0,0,0,0,0,0
250235261005,1758,1694,9,4,14,0,1,36,1737,1679,9,2,14,0,0,33,21,15,0,2,0,0,1,3
250235301001,1775,1702,25,1,18,0,7,22,1759,1695,25,1,18,0,3,17,16,7,0,0,0,0,4,5
250235301002,2033,1792,113,20,24,1,43,40,1936,1744,102,17,24,1,14,34,97,48,11,3,0,0,29,6
250235302001,854,742,8,3,17,0,42,42,845,734,8,3,17,0,42,41,9,8,0,0,0,0,0,1
250235302002,1287,1077,84,5,15,3,60,43,1244,1053,83,5,15,3,46,39,43,24,1,0,0,0,14,4
250235302003,1459,1272,46,12,8,0,68,53,1422,1251,45,11,8,0,55,52,37,21,1,1,0,0,13,1
250235303001,817,765,12,2,8,0,12,18,794,744,12,2,8,0,12,16,23,21,0,0,0,0,0,2
250235303002,1156,1063,21,0,7,0,35,30,1126,1048,21,0,5,0,24,28,30,15,0,0,2,0,11,2
250235303003,852,776,17,3,20,0,6,30,837,765,15,3,20,0,5,29,15,11,2,0,0,0,1,1
250235303004,957,898,6,2,3,3,29,16,944,888,6,2,3,3,26,16,13,10,0,0,0,0,3,0
250235304001,1813,1742,16,12,18,0,8,17,1782,1729,12,4,18,0,4,15,31,13,4,8,0,0,4,2
250235304002,1277,1231,15,0,9,0,16,6,1265,1220,15,0,9,0,15,6,12,11,0,0,0,0,1,0
250235304003,1697,1638,13,1,20,0,2,23,1681,1625,13,1,20,0,2,20,16,13,0,0,0,0,0,3
250235304004,1036,1004,8,1,19,0,0,4,1027,996,8,1,19,0,0,3,9,8,0,0,0,0,0,1
250235305001,1028,937,23,5,17,2,23,21,1013,926,23,5,17,2,20,20,15,11,0,0,0,0,3,1
250235305002,872,801,21,1,5,0,9,35,867,796,21,1,5,0,9,35,5,5,0,0,0,0,0,0
250235305003,1174,1004,38,3,43,0,32,54,1154,989,38,3,43,0,29,52,20,15,0,0,0,0,3,2
250235305004,638,590,8,5,3,0,14,18,629,583,8,5,3,0,12,18,9,7,0,0,0,0,2,0
250235305005,1968,1922,8,8,6,0,4,20,1959,1917,8,7,6,0,2,19,9,5,0,1,0,0,2,1
250235306001,1905,1558,267,22,7,0,45,6,1763,1428,262,22,7,0,38,6,142,130,5,0,0,0,7,0
250235306002,641,605,9,0,11,0,9,7,637,602,9,0,11,0,8,7,4,3,0,0,0,0,1,0
250235306003,1178,1143,15,0,3,2,1,14,1166,1134,15,0,3,2,0,12,12,9,0,0,0,0,1,2
250235306004,1179,1064,70,4,6,0,19,16,1126,1031,66,3,6,0,8,12,53,33,4,1,0,0,11,4
250235306005,1461,1416,8,0,3,0,18,16,1448,1407,8,0,3,0,16,14,13,9,0,0,0,0,2,2
250235307001,1152,1114,5,3,6,2,2,20,1132,1100,5,3,6,2,0,16,20,14,0,0,0,0,2,4
250235307002,3090,2965,32,6,35,1,18,33,3048,2939,32,6,35,1,7,28,42,26,0,0,0,0,11,5
250235308011,2938,2838,22,3,26,2,6,41,2903,2815,22,3,26,2,3,32,35,23,0,0,0,0,3,9
250235308012,2649,2560,18,4,20,0,9,38,2616,2540,18,4,20,0,1,33,33,20,0,0,0,0,8,5
250235308021,705,684,4,1,5,0,3,8,697,678,3,1,5,0,3,7,8,6,1,0,0,0,0,1
250235308022,683,646,9,3,5,0,5,15,675,645,9,3,5,0,1,12,8,1,0,0,0,0,4,3
250235308023,1206,1153,12,2,3,0,4,32,1191,1140,12,1,3,0,3,32,15,13,0,1,0,0,1,0
250235308024,1173,1114,15,11,8,0,3,22,1152,1096,15,10,8,0,3,20,21,18,0,1,0,0,0,2
250235308025,1018,993,4,0,3,0,6,12,1011,987,4,0,3,0,5,12,7,6,0,0,0,0,1,0
250235309011,2211,2092,34,6,13,0,11,55,2175,2066,28,5,13,0,8,55,36,26,6,1,0,0,3,0
250235309012,1480,1408,25,4,4,2,10,27,1453,1390,25,3,4,2,3,26,27,18,0,1,0,0,7,1
250235309013,3741,3515,56,14,62,0,35,59,3655,3448,55,14,62,0,21,55,86,67,1,0,0,0,14,4
250235309014,896,857,7,11,2,2,3,14,890,853,5,11,2,2,3,14,6,4,2,0,0,0,0,0
250235309021,2481,2367,32,8,22,0,20,32,2450,2345,31,8,22,0,12,32,31,22,1,0,0,0,8,0
250235309022,1988,1907,21,7,12,2,12,27,1966,1891,19,7,12,2,8,27,22,16,2,0,0,0,4,0
250235401011,1153,1117,4,1,12,0,6,13,1142,1110,2,1,12,0,6,11,11,7,2,0,0,0,0,2
250235401012,1326,1292,9,0,8,0,5,12,1322,1288,9,0,8,0,5,12,4,4,0,0,0,0,0,0
250235401013,1304,1247,19,1,9,0,9,19,1288,1232,19,1,9,0,9,18,16,15,0,0,0,0,0,1
250235401021,2570,2504,15,3,12,0,8,28,2546,2484,15,3,12,0,4,28,24,20,0,0,0,0,4,0
250235401031,2439,2351,13,8,19,0,10,38,2415,2333,13,8,19,0,8,34,24,18,0,0,0,0,2,4
250235401032,1810,1751,20,0,26,1,6,6,1797,1740,20,0,26,1,6,4,13,11,0,0,0,0,0,2
250235411001,1894,1819,9,2,12,0,24,28,1879,1807,9,2,12,0,22,27,15,12,0,0,0,0,2,1
250235411002,2150,2055,24,1,12,0,13,45,2131,2040,24,1,12,0,13,41,19,15,0,0,0,0,0,4
250235411003,1188,1130,18,1,9,0,9,21,1182,1126,18,1,9,0,9,19,6,4,0,0,0,0,0,2
250235421011,1762,1677,31,4,14,0,10,26,1737,1656,28,4,14,0,10,25,25,21,3,0,0,0,0,1
250235421012,2356,2249,39,4,11,0,17,36,2327,2230,38,4,11,0,11,33,29,19,1,0,0,0,6,3
250235421013,2059,1988,20,2,6,0,20,23,2035,1967,18,2,6,0,19,23,24,21,2,0,0,0,1,0
250235421014,954,919,5,1,3,1,1,24,917,889,5,1,3,0,1,18,37,30,0,0,0,1,0,6
250235421021,2552,2409,65,7,10,0,23,38,2528,2389,65,7,10,0,21,36,24,20,0,0,0,0,2,2
250235422001,2062,1983,35,0,10,0,20,14,2032,1955,34,0,10,0,19,14,30,28,1,0,0,0,1,0
250235422002,2284,2236,11,5,4,0,1,27,2274,2228,11,5,4,0,0,26,10,8,0,0,0,0,1,1
250235422003,1768,1710,25,6,5,0,7,15,1739,1682,25,6,5,0,7,14,29,28,0,0,0,0,0,1
250235423001,1314,1235,17,6,28,0,11,17,1299,1223,15,5,28,0,11,17,15,12,2,1,0,0,0,0
250235423002,1399,1287,29,6,18,2,9,48,1349,1257,29,5,17,1,1,39,50,30,0,1,1,1,8,9
250235423003,662,634,2,0,13,0,0,13,648,621,2,0,13,0,0,12,14,13,0,0,0,0,0,1
250235423004,1494,1415,24,4,27,0,1,23,1469,1396,22,4,26,0,0,21,25,19,2,0,1,0,1,2
250235423005,1660,1535,44,11,16,0,16,38,1620,1517,36,5,16,0,10,36,40,18,8,6,0,0,6,2
250235423006,790,733,14,0,5,1,11,26,775,720,14,0,5,1,9,26,15,13,0,0,0,0,2,0
250235431001,1038,1000,12,0,15,0,4,7,1025,988,12,0,15,0,3,7,13,12,0,0,0,0,1,0
250235431002,1782,1731,12,8,7,0,4,20,1759,1720,11,2,7,0,2,17,23,11,1,6,0,0,2,3
250235441001,1243,1178,16,6,8,0,16,19,1236,1174,16,6,8,0,13,19,7,4,0,0,0,0,3,0
250235441002,1581,1462,43,2,12,0,36,26,1561,1449,40,2,12,0,32,26,20,13,3,0,0,0,4,0
250235441003,1709,1625,17,4,5,0,7,51,1691,1610,17,4,5,0,7,48,18,15,0,0,0,0,0,3
250235441004,1096,1066,6,1,2,0,8,13,1085,1061,6,1,2,0,3,12,11,5,0,0,0,0,5,1
250235442001,1781,1718,14,1,8,0,9,31,1760,1707,13,1,8,0,7,24,21,11,1,0,0,0,2,7
250235442002,1225,1174,15,2,2,0,22,10,1203,1161,15,2,2,0,14,9,22,13,0,0,0,0,8,1
250235442003,1171,1134,14,1,1,0,3,18,1155,1122,14,1,1,0,1,16,16,12,0,0,0,0,2,2
250251707022,1474,946,94,9,77,0,287,61,834,609,90,2,76,0,20,37,640,337,4,7,1,0,267,24
250251707023,1658,822,81,4,309,0,370,72,890,459,68,0,308,0,30,25,768,363,13,4,1,0,340,47
250251707024,959,500,59,2,105,0,242,51,541,319,54,1,105,0,46,16,418,181,5,1,0,0,196,35
250251707025,1391,797,69,3,234,0,220,68,903,552,61,2,234,0,20,34,488,245,8,1,0,0,200,34
250251708001,1815,1357,100,5,49,2,243,59,1362,1162,87,1,49,0,26,37,453,195,13,4,0,2,217,22
250251708002,1359,1061,56,5,41,0,138,58,1012,884,47,1,40,0,11,29,347,177,9,4,1,0,127,29
250251708003,967,793,38,5,0,0,105,26,720,661,36,0,0,0,8,15,247,132,2,5,0,0,97,11
250251708004,977,776,62,16,15,0,77,31,714,618,60,1,15,0,12,8,263,158,2,15,0,0,65,23
250251801011,1207,1104,22,0,15,0,43,23,1130,1067,21,0,15,0,9,18,77,37,1,0,0,0,34,5
250251801012,1215,1177,14,1,9,0,8,6,1188,1159,13,1,9,0,1,5,27,18,1,0,0,0,7,1
250251801013,2344,2045,97,5,33,0,98,66,2169,1959,94,4,32,0,36,44,175,86,3,1,1,0,62,22
250251802001,1471,1277,46,4,33,0,74,37,1330,1208,42,1,33,0,19,27,141,69,4,3,0,0,55,10
250251802002,647,625,4,2,4,0,3,9,618,602,4,2,4,0,0,6,29,23,0,0,0,0,3,3
250251802003,648,621,6,3,3,0,2,13,627,606,6,3,3,0,0,9,21,15,0,0,0,0,2,4
250251802004,1343,1244,32,0,18,0,37,12,1268,1195,32,0,18,0,17,6,75,49,0,0,0,0,20,6
250251803011,652,586,7,1,19,0,23,16,613,567,6,1,19,0,9,11,39,19,1,0,0,0,14,5
250251803012,778,751,4,0,13,1,5,4,744,721,4,0,13,0,2,4,34,30,0,0,0,1,3,0
250251803013,834,788,13,0,10,3,11,9,818,776,11,0,10,3,9,9,16,12,2,0,0,0,2,0
250251803014,760,742,1,1,3,1,1,11,724,710,0,0,2,1,0,11,36,32,1,1,1,0,1,0
250251804001,876,802,22,0,3,0,22,27,820,771,22,0,3,0,6,18,56,31,0,0,0,0,16,9
250251804002,839,800,3,1,5,0,26,4,802,779,3,1,5,0,11,3,37,21,0,0,0,0,15,1
250251805001,1273,1102,22,6,20,0,87,36,1160,1076,21,3,20,0,12,28,113,26,1,3,0,0,75,8
250251805002,572,548,8,2,3,0,6,5,556,539,8,1,3,0,2,3,16,9,0,1,0,0,4,2
250251805003,1156,987,46,0,15,2,60,46,1007,915,38,0,14,2,4,34,149,72,8,0,1,0,56,12
250251805004,882,856,4,3,6,0,4,9,857,836,4,2,6,0,1,8,25,20,0,1,0,0,3,1
250259801011,535,210,217,2,8,1,79,18,401,165,204,2,8,1,13,8,134,45,13,0,0,0,66,10
250259803001,338,190,115,2,10,0,14,7,270,147,107,2,10,0,0,4,68,43,8,0,0,0,14,3
250259807001,6,5,0,0,0,1,0,0,6,5,0,0,0,1,0,0,0,0,0,0,0,0,0,0
250259810001,22,3,14,0,0,0,0,5,22,3,14,0,0,0,0,5,0,0,0,0,0,0,0,0
250259811001,0,0,0,0,0,0,0,0,0,0,0,0,0,0,0,0,0,0,0,0,0,0,0,0
250259811002,12,0,12,0,0,0,0,0,12,0,12,0,0,0,0,0,0,0,0,0,0,0,0,0
250259811003,6,5,0,0,0,0,0,1,6,5,0,0,0,0,0,1,0,0,0,0,0,0,0,0
250259811004,400,124,234,0,14,0,22,6,315,79,216,0,13,0,2,5,85,45,18,0,1,0,20,1
250259812011,0,0,0,0,0,0,0,0,0,0,0,0,0,0,0,0,0,0,0,0,0,0,0,0
250259812021,207,184,16,0,2,1,3,1,170,155,11,0,2,1,0,1,37,29,5,0,0,0,3,0
250259813001,0,0,0,0,0,0,0,0,0,0,0,0,0,0,0,0,0,0,0,0,0,0,0,0
250259813002,389,315,13,4,31,1,10,15,318,258,13,4,29,0,0,14,71,57,0,0,2,1,10,1
250259815011,12,8,3,0,1,0,0,0,11,7,3,0,1,0,0,0,1,1,0,0,0,0,0,0
250259815021,9,9,0,0,0,0,0,0,7,7,0,0,0,0,0,0,2,2,0,0,0,0,0,0
250259816001,0,0,0,0,0,0,0,0,0,0,0,0,0,0,0,0,0,0,0,0,0,0,0,0
250259817001,0,0,0,0,0,0,0,0,0,0,0,0,0,0,0,0,0,0,0,0,0,0,0,0
250259818001,82,73,5,0,3,0,0,1,79,71,5,0,3,0,0,0,3,2,0,0,0,0,0,1
250259901010,0,0,0,0,0,0,0,0,0,0,0,0,0,0,0,0,0,0,0,0,0,0,0,0
250277001001,935,906,7,0,5,1,8,8,911,895,2,0,5,1,0,8,24,11,5,0,0,0,8,0
250277001002,1323,1274,8,2,9,0,11,19,1291,1258,8,0,9,0,2,14,32,16,0,2,0,0,9,5
250277001003,1020,934,22,3,29,0,4,28,987,914,21,3,29,0,0,20,33,20,1,0,0,0,4,8
250277001004,888,847,11,0,16,0,7,7,872,838,11,0,16,0,0,7,16,9,0,0,0,0,7,0
250277001005,1915,1848,11,3,12,1,8,32,1865,1808,11,3,12,1,0,30,50,40,0,0,0,0,8,2
250277011001,2046,1926,39,5,24,0,24,28,1968,1894,29,2,24,0,2,17,78,32,10,3,0,0,22,11
250277011002,1233,1137,26,1,22,0,19,28,1175,1112,25,1,22,0,0,15,58,25,1,0,0,0,19,13
250277011003,880,807,15,0,28,0,5,25,840,777,14,0,28,0,0,21,40,30,1,0,0,0,5,4
250277011004,2721,2538,42,4,94,0,17,26,2659,2495,40,3,94,0,1,26,62,43,2,1,0,0,16,0
250277011005,664,622,7,5,9,0,8,13,634,601,2,5,9,0,4,13,30,21,5,0,0,0,4,0
250277011006,796,768,9,0,3,0,9,7,764,749,8,0,2,0,0,5,32,19,1,0,1,0,9,2
250277022001,1960,1874,16,2,10,0,13,45,1909,1848,15,2,10,0,0,34,51,26,1,0,0,0,13,11
250277022002,1258,1219,7,9,9,0,4,10,1225,1203,3,1,9,0,0,9,33,16,4,8,0,0,4,1
250277031001,1037,967,13,6,11,0,15,25,987,946,12,3,11,0,0,15,50,21,1,3,0,0,15,10
250277031002,1178,1118,15,5,4,0,8,28,1137,1099,14,3,4,0,0,17,41,19,1,2,0,0,8,11
250277031003,2108,2033,23,3,4,0,18,27,2011,1975,9,2,4,0,1,20,97,58,14,1,0,0,17,7
250277032001,1169,1115,8,3,11,0,10,22,1140,1091,8,3,11,0,5,22,29,24,0,0,0,0,5,0
250277032002,1386,1345,10,1,8,0,7,15,1360,1330,8,1,8,0,1,12,26,15,2,0,0,0,6,3
250277032003,1003,939,13,0,16,0,12,23,973,924,13,0,15,0,2,19,30,15,0,0,1,0,10,4
250277033001,2071,1948,24,6,26,0,28,39,1971,1881,24,2,26,0,5,33,100,67,0,4,0,0,23,6
250277033002,1632,1575,7,5,4,0,16,25,1592,1558,7,3,4,0,1,19,40,17,0,2,0,0,15,6
250277042001,1682,1624,20,0,9,0,5,24,1644,1593,20,0,9,0,0,22,38,31,0,0,0,0,5,2
250277042002,1234,1213,2,1,5,0,3,10,1221,1204,2,1,5,0,0,9,13,9,0,0,0,0,3,1
250277051001,657,639,2,1,5,0,4,6,646,634,2,1,5,0,0,4,11,5,0,0,0,0,4,2
250277051002,1595,1547,16,2,4,0,3,23,1549,1513,13,1,4,0,1,17,46,34,3,1,0,0,2,6
250277051003,2334,2259,20,4,11,0,9,31,2287,2231,20,2,11,0,2,21,47,28,0,2,0,0,7,10
250277051004,1169,1139,4,2,8,0,1,15,1156,1128,2,2,8,0,1,15,13,11,2,0,0,0,0,0
250277051005,2258,2168,16,1,14,0,13,46,2222,2150,15,1,14,0,0,42,36,18,1,0,0,0,13,4
250277061001,2800,2711,24,2,20,0,12,31,2754,2676,19,1,20,0,7,31,46,35,5,1,0,0,5,0
250277061002,1582,1559,2,0,1,0,5,15,1565,1549,2,0,1,0,0,13,17,10,0,0,0,0,5,2
250277071001,1448,1397,18,0,6,1,10,16,1405,1368,15,0,6,1,0,15,43,29,3,0,0,0,10,1
250277071002,1829,1647,53,6,12,0,42,69,1576,1487,38,2,12,0,0,37,253,160,15,4,0,0,42,32
250277071003,632,601,1,0,14,0,4,12,628,598,1,0,14,0,4,11,4,3,0,0,0,0,0,1
250277072001,1839,1697,41,8,32,0,23,38,1702,1607,33,0,32,0,1,29,137,90,8,8,0,0,22,9
250277073001,1107,996,21,7,17,5,22,39,1043,969,19,6,17,0,0,32,64,27,2,1,0,5,22,7
250277073002,1782,1666,33,3,27,0,20,33,1700,1622,24,1,27,0,0,26,82,44,9,2,0,0,20,7
250277073003,1042,913,31,5,27,0,27,39,960,876,26,4,27,0,0,27,82,37,5,1,0,0,27,12
250277074001,2497,2354,16,2,23,0,48,54,2371,2292,12,2,21,0,5,39,126,62,4,0,2,0,43,15
250277074002,1119,1051,24,3,12,0,7,22,1073,1014,24,3,12,0,0,20,46,37,0,0,0,0,7,2
250277074003,975,902,26,4,17,0,4,22,934,871,21,3,17,0,2,20,41,31,5,1,0,0,2,2
250277075001,1847,1698,26,6,28,2,39,48,1738,1629,22,6,28,1,10,42,109,69,4,0,0,1,29,6
250277075002,2152,1795,243,17,18,2,56,21,1813,1531,231,14,18,2,1,16,339,264,12,3,0,0,55,5
250277075003,1959,1779,35,3,60,0,47,35,1855,1731,34,3,60,0,0,27,104,48,1,0,0,0,47,8
250277081001,1510,1462,9,3,17,0,3,16,1480,1439,7,2,17,0,2,13,30,23,2,1,0,0,1,3
250277081002,842,816,0,9,8,0,4,5,815,797,0,7,8,0,2,1,27,19,0,2,0,0,2,4
250277081003,2073,1969,30,1,21,0,12,40,2026,1940,29,1,21,0,3,32,47,29,1,0,0,0,9,8
250277081004,1707,1649,15,1,22,0,6,14,1653,1604,15,1,22,0,0,11,54,45,0,0,0,0,6,3
250277081005,1145,1111,11,0,5,0,11,7,1110,1088,11,0,5,0,0,6,35,23,0,0,0,0,11,1
250277091001,1843,1762,14,1,15,0,13,38,1791,1724,14,1,15,0,0,37,52,38,0,0,0,0,13,1
250277091002,1250,1164,33,1,9,0,13,30,1171,1108,31,0,9,0,0,23,79,56,2,1,0,0,13,7
250277091003,973,761,60,2,32,0,86,32,710,605,42,2,29,0,8,24,263,156,18,0,3,0,78,8
250277092011,2038,1911,32,3,21,4,42,25,1931,1848,29,2,20,4,9,19,107,63,3,1,1,0,33,6
250277092012,1117,987,34,4,9,0,47,36,985,913,33,4,9,0,10,16,132,74,1,0,0,0,37,20
250277092013,2281,1794,114,5,54,1,239,74,1771,1562,98,5,50,1,15,40,510,232,16,0,4,0,224,34
250277092014,1485,1372,26,0,36,0,16,35,1418,1334,21,0,36,0,0,27,67,38,5,0,0,0,16,8
250277092021,2796,2268,174,4,120,1,132,97,2497,2077,159,3,119,1,65,73,299,191,15,1,1,0,67,24
250277092022,2967,2372,188,2,96,9,195,105,2334,1956,171,1,96,6,47,57,633,416,17,1,0,3,148,48
250277092023,1066,834,63,5,18,1,109,36,769,654,52,5,18,1,11,28,297,180,11,0,0,0,98,8
250277094001,2500,1895,107,12,152,4,238,92,1885,1575,94,7,147,0,12,50,615,320,13,5,5,4,226,42
250277094002,2250,1651,144,5,102,0,265,83,1523,1250,95,3,96,0,31,48,727,401,49,2,6,0,234,35
250277095011,2149,1973,62,0,52,0,25,37,2057,1912,60,0,52,0,9,24,92,61,2,0,0,0,16,13
250277095021,1242,1038,72,1,61,0,37,33,1117,943,68,1,61,0,15,29,125,95,4,0,0,0,22,4
250277095022,2544,2325,99,5,59,1,10,45,2450,2246,94,5,59,1,3,42,94,79,5,0,0,0,7,3
250277095023,1884,1556,154,3,67,0,75,29,1744,1487,143,3,67,0,18,26,140,69,11,0,0,0,57,3
250277096001,668,533,66,1,8,0,42,18,513,423,63,1,8,0,6,12,155,110,3,0,0,0,36,6
250277096002,721,634,16,0,17,0,35,19,638,587,16,0,17,0,4,14,83,47,0,0,0,0,31,5
250277096003,1034,683,137,6,22,0,148,38,767,537,123,3,22,0,60,22,267,146,14,3,0,0,88,16
250277097011,1331,810,217,9,44,0,175,76,818,531,207,0,44,0,10,26,513,279,10,9,0,0,165,50
250277097012,971,754,72,2,50,0,52,41,839,687,61,2,50,0,12,27,132,67,11,0,0,0,40,14
250277097013,840,748,23,0,10,0,45,14,739,697,18,0,10,0,6,8,101,51,5,0,0,0,39,6
250277097014,1043,982,22,1,15,0,15,8,981,941,18,0,15,0,0,7,62,41,4,1,0,0,15,1
250277097015,1424,1306,52,0,6,1,16,43,1294,1212,40,0,6,1,0,35,130,94,12,0,0,0,16,8
250277097021,1160,1072,33,0,9,1,27,18,1083,1024,33,0,9,1,3,13,77,48,0,0,0,0,24,5
250277097022,1182,990,46,1,40,0,56,49,1034,912,43,1,40,0,9,29,148,78,3,0,0,0,47,20
250277101001,1220,947,43,10,91,0,85,44,941,780,39,9,90,0,3,20,279,167,4,1,1,0,82,24
250277101002,654,491,26,3,53,0,50,31,444,356,18,3,53,0,0,14,210,135,8,0,0,0,50,17
250277101003,663,483,60,1,17,1,78,23,481,426,29,1,17,0,0,8,182,57,31,0,0,1,78,15
250277101004,898,604,81,10,37,0,139,27,607,479,70,9,37,0,0,12,291,125,11,1,0,0,139,15
250277102001,929,577,57,0,55,0,183,57,581,450,43,0,53,0,1,34,348,127,14,0,2,0,182,23
250277102002,637,592,13,1,9,0,17,5,593,564,12,1,9,0,5,2,44,28,1,0,0,0,12,3
250277102003,812,722,19,3,21,1,20,26,752,689,19,1,21,1,2,19,60,33,0,2,0,0,18,7
250277102004,1170,707,112,4,72,0,227,48,664,484,87,1,72,0,3,17,506,223,25,3,0,0,224,31
250277102005,1921,1776,34,4,39,0,38,30,1827,1734,33,3,39,0,4,14,94,42,1,1,0,0,34,16
250277102006,1290,1189,32,1,29,0,11,28,1218,1143,18,1,29,0,2,25,72,46,14,0,0,0,9,3
250277103001,1488,1294,78,8,39,0,24,45,1329,1198,50,4,39,0,5,33,159,96,28,4,0,0,19,12
250277103002,1736,1476,71,6,65,0,65,53,1499,1332,60,4,64,0,6,33,237,144,11,2,1,0,59,20
250277104001,1098,909,20,5,83,0,60,21,910,795,19,1,83,0,2,10,188,114,1,4,0,0,58,11
250277104002,1051,935,21,1,43,0,28,23,968,894,18,0,43,0,1,12,83,41,3,1,0,0,27,11
250277105001,988,699,55,5,59,0,95,75,667,519,39,3,55,0,2,49,321,180,16,2,4,0,93,26
250277105002,1307,849,87,10,62,0,234,65,786,636,59,6,61,0,1,23,521,213,28,4,1,0,233,42
250277105003,951,679,47,9,31,5,126,54,653,565,31,1,30,0,1,25,298,114,16,8,1,5,125,29
250277106001,876,589,36,8,55,0,135,53,557,441,28,2,55,0,4,27,319,148,8,6,0,0,131,26
250277106002,1321,970,98,0,43,0,143,67,909,756,73,0,42,0,6,32,412,214,25,0,1,0,137,35
250277106003,1344,855,83,2,64,0,265,75,825,647,64,0,64,0,4,46,519,208,19,2,0,0,261,29
250277106004,1628,1354,62,9,35,0,130,38,1346,1228,51,1,34,0,2,30,282,126,11,8,1,0,128,8
250277106005,1425,1013,82,5,18,0,230,77,956,832,51,4,18,0,8,43,469,181,31,1,0,0,222,34
250277107001,724,455,78,0,23,0,121,47,423,309,68,0,23,0,1,22,301,146,10,0,0,0,120,25
250277107002,856,606,47,0,22,0,138,43,578,493,35,0,22,0,2,26,278,113,12,0,0,0,136,17
250277108001,1375,1070,124,4,33,0,102,42,1104,944,104,0,33,0,0,23,271,126,20,4,0,0,102,19
250277108002,1303,928,101,1,30,0,175,68,898,743,83,1,29,0,5,37,405,185,18,0,1,0,170,31
250277108003,1861,1338,129,2,19,1,301,71,1341,1170,99,2,19,1,7,43,520,168,30,0,0,0,294,28
250277110001,1171,977,36,1,38,0,64,55,948,844,34,1,37,0,1,31,223,133,2,0,1,0,63,24
250277110002,853,585,59,0,64,0,117,28,645,501,53,0,64,0,1,26,208,84,6,0,0,0,116,2
250277110003,1056,634,101,17,58,2,185,59,686,496,77,7,58,2,1,45,370,138,24,10,0,0,184,14
250277111001,3394,3077,96,2,102,3,59,55,3212,2964,89,2,102,3,7,45,182,113,7,0,0,0,52,10
250277111002,2318,2149,61,1,56,0,12,39,2243,2090,61,1,56,0,2,33,75,59,0,0,0,0,10,6
250277121011,1267,1205,2,0,32,0,20,8,1235,1191,2,0,32,0,2,8,32,14,0,0,0,0,18,0
250277121012,1875,1796,18,3,20,0,18,20,1821,1760,14,3,20,0,6,18,54,36,4,0,0,0,12,2
250277121013,1641,1552,27,0,27,0,8,27,1604,1528,23,0,27,0,3,23,37,24,4,0,0,0,5,4
250277121014,1172,1112,8,6,17,0,7,22,1144,1100,6,5,13,0,2,18,28,12,2,1,4,0,5,4
250277121021,2406,2306,19,4,25,0,12,40,2346,2266,19,4,25,0,1,31,60,40,0,0,0,0,11,9
250277121022,1725,1629,16,4,36,0,2,38,1696,1606,15,4,36,0,1,34,29,23,1,0,0,0,1,4
250277131001,1993,1735,140,1,36,0,47,34,1874,1694,119,0,36,0,3,22,119,41,21,1,0,0,44,12
250277131002,1900,1503,202,3,26,0,114,52,1718,1452,185,2,26,0,25,28,182,51,17,1,0,0,89,24
250277131003,976,899,21,0,21,0,21,14,942,892,15,0,21,0,1,13,34,7,6,0,0,0,20,1
250277131004,3186,2822,261,3,57,0,17,26,2866,2530,253,3,57,0,1,22,320,292,8,0,0,0,16,4
250277151001,2294,2163,14,5,70,0,4,38,2251,2129,14,5,70,0,2,31,43,34,0,0,0,0,2,7
250277151002,2603,2486,9,2,60,1,4,41,2559,2448,8,2,60,1,1,39,44,38,1,0,0,0,3,2
250277161001,2042,1884,36,1,46,0,22,53,1936,1810,30,1,46,0,6,43,106,74,6,0,0,0,16,10
250277161002,1082,956,19,1,17,1,75,13,908,862,16,0,16,0,5,9,174,94,3,1,1,1,70,4
250277161003,1116,854,103,4,7,1,121,26,805,713,71,1,7,0,3,10,311,141,32,3,0,1,118,16
250277161004,876,810,5,4,7,2,29,19,833,792,4,2,7,2,9,17,43,18,1,2,0,0,20,2
250277161005,2442,2164,53,5,45,0,116,59,2218,2063,35,5,45,0,27,43,224,101,18,0,0,0,89,16
250277162001,1644,1364,96,8,21,1,102,52,1360,1205,78,5,20,0,23,29,284,159,18,3,1,1,79,23
250277162002,1176,1021,66,8,25,0,40,16,1038,942,50,8,25,0,4,9,138,79,16,0,0,0,36,7
250277163001,784,708,16,2,3,0,40,15,690,663,11,2,3,0,6,5,94,45,5,0,0,0,34,10
250277163002,1367,1216,22,7,4,0,91,27,1150,1095,10,0,4,0,28,13,217,121,12,7,0,0,63,14
250277163003,1077,868,54,7,7,0,110,31,824,739,36,1,7,0,18,23,253,129,18,6,0,0,92,8
250277171001,743,702,4,4,7,0,8,18,729,694,3,2,7,0,5,18,14,8,1,2,0,0,3,0
250277171002,2123,2050,15,5,33,0,2,18,2093,2021,15,5,33,0,1,18,30,29,0,0,0,0,1,0
250277181001,2026,1888,13,3,80,0,11,31,1997,1868,12,3,80,0,5,29,29,20,1,0,0,0,6,2
250277181002,647,590,4,6,25,0,11,11,636,587,4,6,25,0,3,11,11,3,0,0,0,0,8,0
250277181003,669,619,10,0,29,0,5,6,654,609,10,0,29,0,0,6,15,10,0,0,0,0,5,0
250277181004,1013,964,3,0,25,0,2,19,1004,957,3,0,25,0,2,17,9,7,0,0,0,0,0,2
250277191001,3246,3132,25,7,35,3,11,33,3175,3076,23,7,35,3,1,30,71,56,2,0,0,0,10,3
250277191002,1794,1746,10,5,12,0,6,15,1751,1709,9,4,12,0,3,14,43,37,1,1,0,0,3,1
250277191003,1438,1397,9,1,15,1,4,11,1415,1377,9,1,15,1,1,11,23,20,0,0,0,0,3,0
250277191004,1330,1296,11,1,6,1,2,13,1309,1279,11,1,5,1,0,12,21,17,0,0,1,0,2,1
250277201001,2019,1962,11,1,23,0,0,22,1994,1941,10,1,23,0,0,19,25,21,1,0,0,0,0,3
250277201002,1394,1356,5,1,17,0,1,14,1370,1336,4,0,17,0,0,13,24,20,1,1,0,0,1,1
250277211011,1902,1856,12,0,8,1,5,20,1856,1819,7,0,8,1,4,17,46,37,5,0,0,0,1,3
250277211021,4168,3966,38,0,96,0,23,45,4090,3902,37,0,96,0,14,41,78,64,1,0,0,0,9,4
250277211022,2111,2041,21,1,13,1,3,31,2080,2018,21,1,13,1,0,26,31,23,0,0,0,0,3,5
250277211023,1694,1618,33,5,17,0,9,12,1657,1590,33,5,17,0,0,12,37,28,0,0,0,0,9,0
250277221001,1735,1687,15,1,8,0,2,22,1706,1665,9,1,8,0,2,21,29,22,6,0,0,0,0,1
250277221002,1009,984,6,4,3,0,3,9,999,976,6,4,2,0,2,9,10,8,0,0,1,0,1,0
250277221003,1771,1670,39,5,16,0,14,27,1733,1651,33,5,16,0,1,27,38,19,6,0,0,0,13,0
250277221004,883,863,0,2,2,0,2,14,857,840,0,2,2,0,2,11,26,23,0,0,0,0,0,3
250277231001,2048,1978,22,4,6,0,7,31,2018,1966,21,3,6,0,0,22,30,12,1,1,0,0,7,9
250277231002,942,917,6,5,0,2,4,8,919,899,6,5,0,2,0,7,23,18,0,0,0,0,4,1
250277231003,999,974,4,4,6,0,1,10,991,968,3,4,6,0,0,10,8,6,1,0,0,0,1,0
250277241001,1265,1233,7,1,7,0,1,16,1249,1224,7,0,7,0,1,10,16,9,0,1,0,0,0,6
250277241002,1068,1046,8,3,1,0,5,5,1044,1030,8,1,1,0,0,4,24,16,0,2,0,0,5,1
250277241003,1368,1305,13,3,15,0,7,25,1345,1295,12,0,15,0,0,23,23,10,1,3,0,0,7,2
250277251001,917,892,4,0,2,2,0,17,904,879,4,0,2,2,0,17,13,13,0,0,0,0,0,0
250277251002,929,907,3,2,0,0,1,16,906,890,3,2,0,0,0,11,23,17,0,0,0,0,1,5
250277251003,744,728,3,1,0,0,4,8,726,716,3,1,0,0,0,6,18,12,0,0,0,0,4,2
250277251004,592,555,2,16,4,0,0,15,580,551,2,11,4,0,0,12,12,4,0,5,0,0,0,3
250277251005,1498,1462,4,0,7,1,4,20,1475,1446,4,0,7,1,1,16,23,16,0,0,0,0,3,4
250277261001,1847,1789,10,4,24,1,7,12,1827,1781,10,4,24,1,0,7,20,8,0,0,0,0,7,5
250277261002,999,969,5,1,4,1,3,16,985,961,5,1,4,1,0,13,14,8,0,0,0,0,3,3
250277261003,1181,1148,5,2,5,0,4,17,1168,1142,4,2,5,0,0,15,13,6,1,0,0,0,4,2
250277261004,1057,1031,4,1,2,0,10,9,1025,1012,2,1,2,0,2,6,32,19,2,0,0,0,8,3
250277261005,904,891,2,3,6,0,0,2,891,881,2,0,6,0,0,2,13,10,0,3,0,0,0,0
250277262001,635,607,10,1,0,3,12,2,612,599,7,1,0,0,3,2,23,8,3,0,0,3,9,0
250277262002,1774,1701,14,2,25,2,13,17,1716,1662,11,0,23,2,1,17,58,39,3,2,2,0,12,0
250277262003,886,838,8,1,1,0,22,16,834,810,8,1,1,0,2,12,52,28,0,0,0,0,20,4
250277262004,723,686,4,3,2,0,6,22,694,670,0,3,2,0,0,19,29,16,4,0,0,0,6,3
250277262005,1682,1589,12,8,15,1,25,32,1601,1543,12,7,12,1,2,24,81,46,0,1,3,0,23,8
250277271001,2517,2339,100,2,30,1,8,37,2418,2274,82,2,30,1,2,27,99,65,18,0,0,0,6,10
250277271002,587,567,0,0,11,0,0,9,572,554,0,0,11,0,0,7,15,13,0,0,0,0,0,2
250277271003,1702,1645,10,2,21,0,8,16,1665,1617,10,1,21,0,1,15,37,28,0,1,0,0,7,1
250277281001,1777,1671,34,1,35,0,8,28,1747,1651,31,1,35,0,3,26,30,20,3,0,0,0,5,2
250277281002,1094,1015,6,0,46,0,3,24,1055,987,6,0,46,0,1,15,39,28,0,0,0,0,2,9
250277281003,1255,1159,8,3,63,0,6,16,1226,1141,6,3,63,0,0,13,29,18,2,0,0,0,6,3
250277282001,909,879,0,0,19,0,3,8,893,867,0,0,19,0,0,7,16,12,0,0,0,0,3,1
250277282002,669,630,5,0,23,0,1,10,662,628,5,0,19,0,0,10,7,2,0,0,4,0,1,0
250277282003,953,887,15,1,28,0,2,20,935,875,15,0,28,0,1,16,18,12,0,1,0,0,1,4
250277282004,1182,1106,21,1,33,0,10,11,1152,1089,20,1,33,0,0,9,30,17,1,0,0,0,10,2
250277283001,1639,1560,29,1,24,0,13,12,1609,1537,28,1,24,0,9,10,30,23,1,0,0,0,4,2
250277283002,2059,1990,5,1,48,0,4,11,2023,1959,4,1,48,0,0,11,36,31,1,0,0,0,4,0
250277283003,846,784,13,2,16,0,13,18,796,758,11,2,16,0,0,9,50,26,2,0,0,0,13,9
250277284001,1950,1749,28,1,134,2,9,27,1918,1730,25,0,134,2,3,24,32,19,3,1,0,0,6,3
250277284002,931,875,13,0,23,0,6,14,915,873,7,0,23,0,3,9,16,2,6,0,0,0,3,5
250277284003,2082,2015,7,0,25,0,18,17,2042,1991,5,0,25,0,4,17,40,24,2,0,0,0,14,0
250277291001,2809,2439,272,16,16,0,37,29,2508,2181,271,16,16,0,1,23,301,258,1,0,0,0,36,6
250277291002,857,840,6,0,4,0,4,3,840,827,6,0,4,0,0,3,17,13,0,0,0,0,4,0
250277291003,1331,1310,4,1,9,1,3,3,1306,1289,3,1,9,1,0,3,25,21,1,0,0,0,3,0
250277292001,816,785,13,0,7,1,6,4,799,771,13,0,7,1,4,3,17,14,0,0,0,0,2,1
250277292002,1131,1085,23,0,7,0,12,4,1102,1061,23,0,7,0,8,3,29,24,0,0,0,0,4,1
250277292003,725,699,5,0,9,0,4,8,710,688,5,0,9,0,0,8,15,11,0,0,0,0,4,0
250277301001,941,691,132,4,58,0,19,37,851,631,129,4,58,0,3,26,90,60,3,0,0,0,16,11
250277301002,767,685,38,1,10,0,19,14,705,643,38,1,10,0,1,12,62,42,0,0,0,0,18,2
250277301003,814,627,110,6,37,0,14,20,762,599,103,5,37,0,0,18,52,28,7,1,0,0,14,2
250277301004,1326,1104,63,3,118,1,8,29,1270,1065,59,0,118,1,0,27,56,39,4,3,0,0,8,2
250277301005,2075,1654,247,3,71,2,40,58,1936,1572,243,3,70,2,8,38,139,82,4,0,1,0,32,20
250277302001,1045,863,91,1,27,0,42,21,960,828,86,1,27,0,5,13,85,35,5,0,0,0,37,8
250277302002,1313,872,257,7,64,0,73,40,1127,780,242,6,64,0,9,26,186,92,15,1,0,0,64,14
250277302003,577,505,22,0,27,1,9,13,534,470,22,0,27,1,1,13,43,35,0,0,0,0,8,0
250277302004,796,729,27,0,19,0,10,11,763,713,26,0,19,0,0,5,33,16,1,0,0,0,10,6
250277302005,712,657,30,0,7,0,9,9,680,633,30,0,7,0,1,9,32,24,0,0,0,0,8,0
250277302006,1140,1017,62,1,29,1,11,19,1084,979,53,1,29,1,5,16,56,38,9,0,0,0,6,3
250277303001,857,675,75,6,18,0,36,47,735,620,63,4,18,0,0,30,122,55,12,2,0,0,36,17
250277303002,1272,1064,79,0,51,0,23,55,1185,1013,69,0,47,0,6,50,87,51,10,0,4,0,17,5
250277303003,1079,979,33,0,31,0,12,24,1021,937,30,0,31,0,0,23,58,42,3,0,0,0,12,1
250277303004,657,551,41,2,19,0,23,21,596,518,40,2,19,0,4,13,61,33,1,0,0,0,19,8
250277303005,694,591,32,10,31,0,17,13,644,563,28,9,31,0,2,11,50,28,4,1,0,0,15,2
250277304011,912,732,107,1,35,0,18,19,863,697,107,0,35,0,8,16,49,35,0,1,0,0,10,3
250277304012,1387,1233,52,2,24,0,39,37,1296,1190,49,2,24,0,7,24,91,43,3,0,0,0,32,13
250277304013,1803,1008,519,10,13,1,176,76,1222,709,458,3,13,1,5,33,581,299,61,7,0,0,171,43
250277304014,1342,716,365,12,24,0,157,68,899,483,332,6,24,0,15,39,443,233,33,6,0,0,142,29
250277304021,884,633,96,3,66,0,59,27,718,540,90,3,66,0,1,18,166,93,6,0,0,0,58,9
250277304022,776,483,138,0,8,0,108,39,525,349,119,0,8,0,20,29,251,134,19,0,0,0,88,10
250277305001,739,543,77,4,17,0,57,41,637,503,71,4,17,0,13,29,102,40,6,0,0,0,44,12
250277305002,1143,564,408,9,24,0,64,74,851,398,391,1,20,0,8,33,292,166,17,8,4,0,56,41
250277305003,1653,1284,171,3,91,3,53,48,1487,1192,155,2,91,3,7,37,166,92,16,1,0,0,46,11
250277306001,3045,2507,202,3,248,0,31,54,2895,2408,194,1,248,0,1,43,150,99,8,2,0,0,30,11
250277306002,1007,902,48,1,37,0,4,15,968,872,44,0,37,0,1,14,39,30,4,1,0,0,3,1
250277306003,1589,1485,51,3,26,1,8,15,1536,1454,42,2,26,1,1,10,53,31,9,1,0,0,7,5
250277306004,2071,1934,48,1,53,1,13,21,1995,1879,47,1,47,0,4,17,76,55,1,0,6,1,9,4
250277306005,1087,952,43,1,33,0,14,44,1047,932,42,1,33,0,3,36,40,20,1,0,0,0,11,8
250277307001,1553,1370,65,4,77,0,13,24,1479,1325,60,0,77,0,1,16,74,45,5,4,0,0,12,8
250277307002,781,647,30,0,56,0,24,24,737,638,27,0,55,0,0,17,44,9,3,0,1,0,24,7
250277307003,811,679,40,0,51,0,21,20,764,662,35,0,47,0,1,19,47,17,5,0,4,0,20,1
250277307004,892,736,72,2,46,1,11,24,829,695,68,2,43,0,0,21,63,41,4,0,3,1,11,3
250277307005,777,649,75,2,35,0,6,10,741,622,72,2,35,0,2,8,36,27,3,0,0,0,4,2
250277307006,1989,1623,183,1,69,1,43,69,1882,1567,162,0,69,1,31,52,107,56,21,1,0,0,12,17
250277308011,1029,942,38,0,15,0,6,28,988,909,37,0,15,0,4,23,41,33,1,0,0,0,2,5
250277308012,1835,1614,73,1,83,0,28,36,1775,1582,68,1,83,0,8,33,60,32,5,0,0,0,20,3
250277308013,801,752,11,0,16,0,13,9,765,731,9,0,16,0,0,9,36,21,2,0,0,0,13,0
250277308021,835,745,35,1,30,0,8,16,774,701,31,0,30,0,0,12,61,44,4,1,0,0,8,4
250277308022,1211,1018,67,0,49,0,19,58,1127,979,58,0,49,0,3,38,84,39,9,0,0,0,16,20
250277309011,854,752,31,2,17,0,29,23,797,727,30,0,17,0,5,18,57,25,1,2,0,0,24,5
250277309012,1262,1096,55,5,35,0,23,48,1167,1047,53,3,32,0,2,30,95,49,2,2,3,0,21,18
250277309013,1288,1131,61,4,37,0,30,25,1230,1109,59,4,37,0,6,15,58,22,2,0,0,0,24,10
250277309021,1838,1620,97,4,39,1,43,34,1738,1566,92,3,38,1,7,31,100,54,5,1,1,0,36,3
250277309022,739,592,50,3,23,0,48,23,654,557,47,3,23,0,9,15,85,35,3,0,0,0,39,8
250277309023,1139,980,38,5,67,0,12,37,1099,958,38,1,67,0,3,32,40,22,0,4,0,0,9,5
250277310011,2229,1562,308,7,273,3,46,30,2013,1411,296,6,270,3,4,23,216,151,12,1,3,0,42,7
250277310021,854,583,71,4,44,0,86,66,654,501,63,2,44,0,4,40,200,82,8,2,0,0,82,26
250277310022,2312,1388,541,10,128,0,138,107,1895,1203,494,8,128,0,8,54,417,185,47,2,0,0,130,53
250277310023,2331,1655,266,17,238,0,103,52,2026,1508,230,6,237,0,11,34,305,147,36,11,1,0,92,18
250277310024,905,569,113,5,123,0,61,34,746,480,106,2,123,0,5,30,159,89,7,3,0,0,56,4
250277311011,841,431,85,5,156,0,110,54,580,325,64,1,156,0,9,25,261,106,21,4,0,0,101,29
250277311012,821,500,122,1,115,0,50,33,706,449,115,1,114,0,7,20,115,51,7,0,1,0,43,13
250277311013,819,693,46,0,45,0,19,16,735,647,34,0,45,0,0,9,84,46,12,0,0,0,19,7
250277311014,1468,805,215,10,115,3,251,69,904,560,187,3,115,0,4,35,564,245,28,7,0,3,247,34
250277311021,854,679,94,1,24,0,30,26,787,653,85,1,24,0,6,18,67,26,9,0,0,0,24,8
250251006012,898,603,148,2,107,0,20,18,855,591,139,1,103,0,8,13,43,12,9,1,4,0,12,5
250251006013,1218,334,445,4,279,0,77,79,1088,307,402,4,278,0,43,54,130,27,43,0,1,0,34,25
250251006014,1944,456,766,1,407,0,225,89,1694,403,709,1,407,0,116,58,250,53,57,0,0,0,109,31
250251006031,1306,911,193,1,133,1,41,26,1209,864,171,1,133,0,17,23,97,47,22,0,0,1,24,3
250251006032,598,470,65,0,27,1,13,22,566,450,64,0,27,1,3,21,32,20,1,0,0,0,10,1
250251007001,1050,937,54,0,27,0,17,15,1014,922,53,0,27,0,3,9,36,15,1,0,0,0,14,6
250251007002,1027,900,35,4,59,0,16,13,1015,891,35,4,59,0,13,13,12,9,0,0,0,0,3,0
250251007003,672,645,9,4,8,0,1,5,655,637,7,1,8,0,0,2,17,8,2,3,0,0,1,3
250251007004,856,801,12,0,30,0,3,10,836,786,10,0,30,0,0,10,20,15,2,0,0,0,3,0
250251007005,717,618,47,0,43,0,9,0,701,611,47,0,43,0,0,0,16,7,0,0,0,0,9,0
250251008001,663,233,212,1,137,1,43,36,569,204,190,0,137,1,16,21,94,29,22,1,0,0,27,15
250251008002,929,580,124,3,176,0,22,24,876,558,112,3,175,0,9,19,53,22,12,0,1,0,13,5
250251008003,899,532,230,5,60,0,19,53,841,521,214,5,56,0,9,36,58,11,16,0,4,0,10,17
250251008004,1117,733,265,0,52,0,20,47,1057,706,254,0,52,0,6,39,60,27,11,0,0,0,14,8
250251008005,807,489,219,3,44,0,14,38,756,468,203,3,42,0,8,32,51,21,16,0,2,0,6,6
250251008006,1131,471,411,4,153,0,47,45,1035,439,391,4,152,0,14,35,96,32,20,0,1,0,33,10
250251009001,761,282,314,0,78,0,56,31,664,256,292,0,78,0,15,23,97,26,22,0,0,0,41,8
250251009002,569,178,251,0,97,0,16,27,529,159,242,0,97,0,11,20,40,19,9,0,0,0,5,7
250251009003,1295,346,811,3,41,3,47,44,1176,328,765,0,41,0,13,29,119,18,46,3,0,3,34,15
250251009004,515,15,463,1,8,0,15,13,475,12,441,0,8,0,2,12,40,3,22,1,0,0,13,1
250251009005,932,184,623,1,57,0,27,40,878,178,602,0,54,0,15,29,54,6,21,1,3,0,12,11
250251010011,721,31,643,7,10,0,13,17,679,27,624,4,9,0,0,15,42,4,19,3,1,0,13,2
250251010012,733,31,637,5,0,0,40,20,662,11,624,4,0,0,8,15,71,20,13,1,0,0,32,5
250251010013,745,25,650,1,0,0,46,23,679,20,625,1,0,0,17,16,66,5,25,0,0,0,29,7
250251010014,952,24,861,1,3,0,44,19,880,17,840,1,3,0,4,15,72,7,21,0,0,0,40,4
250251010015,1099,102,815,9,1,0,119,53,842,41,771,1,1,0,4,24,257,61,44,8,0,0,115,29
250251010016,1230,38,1087,7,0,0,42,56,1144,17,1067,7,0,0,11,42,86,21,20,0,0,0,31,14
250251010021,802,116,436,14,11,0,170,55,516,61,407,3,11,0,19,15,286,55,29,11,0,0,151,40
250251010022,2261,161,1871,14,25,0,92,98,1989,111,1764,9,25,0,14,66,272,50,107,5,0,0,78,32
250251010023,1916,41,1733,7,18,3,50,64,1781,29,1663,7,17,0,14,51,135,12,70,0,1,3,36,13
250251011011,775,0,596,3,0,0,128,48,565,0,527,2,0,0,3,33,210,0,69,1,0,0,125,15
250251011012,904,20,819,2,1,0,24,38,831,13,790,2,1,0,6,19,73,7,29,0,0,0,18,19
250251011013,1476,48,1260,3,1,1,99,64,1280,16,1215,3,1,0,1,44,196,32,45,0,0,1,98,20
250251011021,849,24,774,2,5,1,29,14,776,7,755,0,5,1,1,7,73,17,19,2,0,0,28,7
250251011022,1494,61,1307,8,6,0,69,43,1271,15,1218,4,5,0,0,29,223,46,89,4,1,0,69,14
250251011023,712,11,651,1,14,0,29,6,664,5,638,1,14,0,0,6,48,6,13,0,0,0,29,0
250251011024,1341,77,1117,14,1,2,65,65,1164,27,1081,10,0,2,2,42,177,50,36,4,1,0,63,23
250251101031,568,369,112,3,27,0,26,31,476,322,101,1,27,0,4,21,92,47,11,2,0,0,22,10
250251101032,733,265,217,1,47,0,175,28,431,171,195,1,47,0,5,12,302,94,22,0,0,0,170,16
250251101033,653,244,167,16,32,0,154,40,329,121,153,8,31,0,0,16,324,123,14,8,1,0,154,24
250251101034,620,300,164,0,17,0,98,41,379,200,152,0,17,0,0,10,241,100,12,0,0,0,98,31
250251101035,1440,933,121,5,218,1,94,68,1250,853,108,1,216,1,18,53,190,80,13,4,2,0,76,15
250251101036,583,446,67,5,30,1,9,25,520,404,62,0,30,1,3,20,63,42,5,5,0,0,6,5
250251101037,863,249,241,12,24,0,264,73,329,67,190,11,22,0,5,34,534,182,51,1,2,0,259,39
250251102011,2051,682,873,35,45,0,312,104,1317,411,795,13,42,0,15,41,734,271,78,22,3,0,297,63
250251103011,1134,408,431,6,41,0,201,47,727,259,378,6,41,0,16,27,407,149,53,0,0,0,185,20
250251103012,1271,819,250,12,20,0,104,66,986,696,224,7,19,0,3,37,285,123,26,5,1,0,101,29
250251104011,2011,703,715,9,36,6,412,130,1042,334,620,1,36,5,7,39,969,369,95,8,0,1,405,91
250251104012,1555,952,332,7,57,0,131,76,1215,783,325,4,56,0,7,40,340,169,7,3,1,0,124,36
250251104031,905,369,380,1,19,0,85,51,641,288,312,1,19,0,4,17,264,81,68,0,0,0,81,34
250251104032,783,481,156,5,16,3,99,23,634,439,145,5,16,3,9,17,149,42,11,0,0,0,90,6
250251104033,657,322,218,2,19,1,45,50,530,279,200,2,19,1,9,20,127,43,18,0,0,0,36,30
250251104034,975,724,84,0,31,0,98,38,731,614,69,0,26,0,9,13,244,110,15,0,5,0,89,25
250251104035,989,643,184,6,30,0,85,41,771,528,169,2,30,0,15,27,218,115,15,4,0,0,70,14
250251105011,849,644,106,4,27,0,37,31,746,607,95,0,27,0,2,15,103,37,11,4,0,0,35,16
250251105012,1498,1156,161,0,33,0,100,48,1277,1064,151,0,33,0,7,22,221,92,10,0,0,0,93,26
250251105013,906,677,81,6,31,0,60,51,769,628,75,1,31,0,1,33,137,49,6,5,0,0,59,18
250251105021,1311,878,212,4,51,0,110,56,993,723,177,0,51,0,8,34,318,155,35,4,0,0,102,22
250251105022,1855,1148,369,11,60,0,180,87,1426,949,351,5,58,0,16,47,429,199,18,6,2,0,164,40
250251105023,640,470,100,1,4,0,49,16,511,398,97,0,4,0,5,7,129,72,3,1,0,0,44,9
250251106011,1915,1717,61,1,106,0,10,20,1850,1665,60,1,105,0,4,15,65,52,1,0,1,0,6,5
250251106012,1054,949,16,9,26,1,22,31,997,915,16,6,26,1,9,24,57,34,0,3,0,0,13,7
250251106071,1013,860,68,2,27,0,41,15,909,801,60,1,24,0,12,11,104,59,8,1,3,0,29,4
250251106072,1529,1308,94,6,42,0,50,29,1358,1216,79,1,41,0,4,17,171,92,15,5,1,0,46,12
250251106073,1586,1306,115,4,23,0,76,62,1399,1224,106,4,23,0,7,35,187,82,9,0,0,0,69,27
250251106074,949,861,19,0,40,0,10,19,924,844,18,0,40,0,6,16,25,17,1,0,0,0,4,3
250251201031,1508,1321,55,2,54,0,20,56,1431,1270,55,1,54,0,8,43,77,51,0,1,0,0,12,13
250251201041,516,422,32,2,30,0,11,19,470,403,24,1,30,0,0,12,46,19,8,1,0,0,11,7
250251201042,799,491,118,1,33,0,125,31,504,363,92,0,33,0,6,10,295,128,26,1,0,0,119,21
250251201043,780,640,39,2,63,0,13,23,714,593,34,1,63,0,2,21,66,47,5,1,0,0,11,2
250251201051,876,632,52,3,142,0,13,34,814,604,48,1,141,0,1,19,62,28,4,2,1,0,12,15
250251201052,933,792,59,3,44,0,9,26,897,768,58,1,44,0,0,26,36,24,1,2,0,0,9,0
250251201053,635,553,14,2,24,1,5,36,583,518,11,0,24,1,4,25,52,35,3,2,0,0,1,11
250251202011,1147,922,89,3,55,0,43,35,1028,862,77,1,52,0,11,25,119,60,12,2,3,0,32,10
250251202012,1841,949,455,14,48,0,286,89,1282,770,405,5,48,0,14,40,559,179,50,9,0,0,272,49
250251202013,451,315,52,1,15,0,45,23,329,271,28,1,15,0,3,11,122,44,24,0,0,0,42,12
250251203011,1166,510,240,26,26,0,256,108,571,295,207,4,25,0,4,36,595,215,33,22,1,0,252,72
250251203012,855,322,236,10,12,0,230,45,432,183,204,2,12,0,8,23,423,139,32,8,0,0,222,22
250251203013,1543,947,280,4,44,0,203,65,1119,804,236,2,44,0,7,26,424,143,44,2,0,0,196,39
250251203014,1231,745,194,5,56,0,154,77,852,626,142,1,55,0,9,19,379,119,52,4,1,0,145,58
250251204001,856,709,65,5,39,0,15,23,788,667,56,4,38,0,4,19,68,42,9,1,1,0,11,4
250251204002,676,543,58,4,32,0,6,33,620,512,53,1,32,0,1,21,56,31,5,3,0,0,5,12
250251204003,895,750,42,2,41,0,25,35,825,715,37,1,40,0,3,29,70,35,5,1,1,0,22,6
250251204004,1862,1475,134,5,79,0,102,67,1604,1347,114,3,79,0,9,52,258,128,20,2,0,0,93,15
250251204005,1462,1167,129,9,71,2,38,46,1348,1103,123,4,70,2,7,39,114,64,6,5,1,0,31,7
250251205001,824,364,155,16,26,0,182,81,422,260,107,2,26,0,3,24,402,104,48,14,0,0,179,57
250251205002,733,452,74,8,11,0,157,31,388,311,45,1,11,0,8,12,345,141,29,7,0,0,149,19
250251205003,774,368,118,14,26,0,190,58,326,193,80,3,26,0,11,13,448,175,38,11,0,0,179,45
250251206001,865,647,66,5,23,0,70,54,675,563,50,3,22,0,8,29,190,84,16,2,1,0,62,25
250251206002,724,620,27,1,35,0,13,28,666,586,27,0,34,0,4,15,58,34,0,1,1,0,9,13
250251206003,746,621,39,2,23,1,25,35,693,602,38,0,23,1,3,26,53,19,1,2,0,0,22,9
250251207001,962,608,132,2,73,0,98,49,713,507,101,2,73,0,4,26,249,101,31,0,0,0,94,23
250251207002,1052,807,73,2,96,1,40,33,947,760,68,1,96,0,4,18,105,47,5,1,0,1,36,15
250251301001,1031,926,17,0,67,0,4,17,988,890,16,0,67,0,2,13,43,36,1,0,0,0,2,4
250251301002,1675,1141,110,1,292,0,65,66,1560,1088,105,1,292,0,21,53,115,53,5,0,0,0,44,13
250251301003,520,432,34,3,33,0,3,15,492,413,31,0,33,0,0,15,28,19,3,3,0,0,3,0
250251301004,810,777,3,0,19,0,1,10,794,762,3,0,19,0,0,10,16,15,0,0,0,0,1,0
250251301005,655,620,2,0,23,0,3,7,632,605,2,0,23,0,0,2,23,15,0,0,0,0,3,5
250251301006,373,322,21,0,26,0,0,4,363,314,21,0,26,0,0,2,10,8,0,0,0,0,0,2
250251301007,842,731,15,0,63,0,16,17,812,717,12,0,63,0,3,17,30,14,3,0,0,0,13,0
250251302001,590,567,5,4,10,0,0,4,566,545,4,4,10,0,0,3,24,22,1,0,0,0,0,1
250251302002,880,759,33,1,55,0,3,29,831,722,30,1,55,0,0,23,49,37,3,0,0,0,3,6
250251302003,1398,1244,48,9,68,0,13,16,1328,1201,41,2,68,0,7,9,70,43,7,7,0,0,6,7
250251302004,704,658,14,0,19,0,9,4,680,647,14,0,19,0,0,0,24,11,0,0,0,0,9,4
250251302005,934,826,21,0,58,1,3,25,894,798,21,0,57,1,0,17,40,28,0,0,1,0,3,8
250251303001,848,782,17,1,22,1,7,18,812,755,16,1,21,1,0,18,36,27,1,0,1,0,7,0
250251303002,1125,984,30,0,62,1,13,35,1070,950,24,0,62,1,1,32,55,34,6,0,0,0,12,3
250251303003,801,752,9,0,19,0,2,19,784,739,8,0,19,0,2,16,17,13,1,0,0,0,0,3
250251303004,983,711,80,0,111,0,60,21,858,669,62,0,110,0,6,11,125,42,18,0,1,0,54,10
250251303005,662,588,34,2,18,0,8,12,625,564,29,2,18,0,4,8,37,24,5,0,0,0,4,4
250251304021,1080,897,47,1,83,0,29,23,976,836,39,1,83,0,5,12,104,61,8,0,0,0,24,11
250251304022,781,655,21,2,71,0,18,14,722,625,15,0,71,0,0,11,59,30,6,2,0,0,18,3
250251304023,1058,867,55,0,91,0,28,17,1011,841,54,0,91,0,9,16,47,26,1,0,0,0,19,1
250251304024,903,749,50,1,85,0,5,13,873,733,40,1,85,0,3,11,30,16,10,0,0,0,2,2
250251304025,815,690,34,0,59,3,22,7,755,660,29,0,59,2,1,4,60,30,5,0,0,1,21,3
250251304041,1892,1414,178,3,141,1,112,43,1657,1307,161,1,141,1,11,35,235,107,17,2,0,0,101,8
250251304042,648,519,36,0,55,0,31,7,573,484,25,0,54,0,3,7,75,35,11,0,1,0,28,0
250251304043,361,293,18,0,36,0,11,3,322,263,18,0,36,0,4,1,39,30,0,0,0,0,7,2
250251304061,2223,346,1477,9,15,0,283,93,1625,190,1363,2,15,0,17,38,598,156,114,7,0,0,266,55
250251304062,2311,1252,652,3,163,0,158,83,1913,1088,609,3,163,0,5,45,398,164,43,0,0,0,153,38
250251304063,573,333,101,6,78,0,32,23,509,316,91,3,78,0,1,20,64,17,10,3,0,0,31,3
250251401021,1186,345,643,2,20,0,132,44,947,273,607,2,20,0,20,25,239,72,36,0,0,0,112,19
250251401022,908,539,224,3,11,1,103,27,756,503,213,1,11,1,11,16,152,36,11,2,0,0,92,11
250251401023,860,539,233,0,12,3,40,33,770,517,217,0,12,0,5,19,90,22,16,0,0,3,35,14
250251401024,1447,525,708,3,48,0,102,61,1173,406,680,1,45,0,2,39,274,119,28,2,3,0,100,22
250251401051,2359,1371,564,5,40,2,257,120,1785,1150,518,1,34,2,15,65,574,221,46,4,6,0,242,55
250251401052,1316,288,772,8,27,0,174,47,935,155,714,2,22,0,17,25,381,133,58,6,5,0,157,22
250251401061,1395,345,797,13,21,0,139,80,1051,245,737,6,20,0,10,33,344,100,60,7,1,0,129,47
250251401062,506,112,207,1,10,0,145,31,255,33,193,1,10,0,3,15,251,79,14,0,0,0,142,16
250251401071,1832,877,670,14,55,0,129,87,1420,686,624,11,53,0,15,31,412,191,46,3,2,0,114,56
250251401072,699,285,292,2,3,0,86,31,493,205,274,1,3,0,1,9,206,80,18,1,0,0,85,22
250251402011,1089,504,374,6,27,0,132,46,877,433,350,4,27,0,36,27,212,71,24,2,0,0,96,19
250251402012,983,578,277,4,24,0,64,36,854,545,257,3,24,0,3,22,129,33,20,1,0,0,61,14
250251402021,916,327,461,5,34,0,74,15,767,277,432,4,34,0,7,13,149,50,29,1,0,0,67,2
250251402022,1456,501,590,11,17,0,246,91,951,366,526,3,17,0,11,28,505,135,64,8,0,0,235,63
250251402023,987,643,225,8,39,0,37,35,867,584,216,1,39,0,4,23,120,59,9,7,0,0,33,12
250251402024,1521,765,518,4,16,6,129,83,1231,670,484,2,16,3,15,41,290,95,34,2,0,3,114,42
250251402025,720,532,144,0,12,2,19,11,649,503,126,0,11,0,1,8,71,29,18,0,1,2,18,3
250251403001,915,280,469,10,20,0,100,36,707,210,435,8,20,0,15,19,208,70,34,2,0,0,85,17
250251403002,862,264,403,4,23,0,127,41,646,193,386,3,23,0,19,22,216,71,17,1,0,0,108,19
250251403003,1423,528,655,3,12,4,168,53,1052,406,598,3,12,0,6,27,371,122,57,0,0,4,162,26
250251403004,705,168,431,4,6,0,70,26,548,106,419,0,6,0,8,9,157,62,12,4,0,0,62,17
250251403005,1134,230,727,2,21,0,106,48,884,157,677,2,21,0,2,25,250,73,50,0,0,0,104,23
250251403006,1343,197,982,4,3,0,110,47,1071,112,933,3,3,0,4,16,272,85,49,1,0,0,106,31
250251404001,654,44,552,6,0,0,36,16,579,28,535,2,0,0,6,8,75,16,17,4,0,0,30,8
250251404002,1003,44,882,8,3,0,35,31,928,34,867,6,3,0,4,14,75,10,15,2,0,0,31,17
250251404003,1049,44,931,16,1,0,26,31,962,33,882,4,1,0,12,30,87,11,49,12,0,0,14,1
250251404004,755,55,643,6,6,0,22,23,680,29,627,6,5,0,0,13,75,26,16,0,1,0,22,10
250251404005,1399,113,1159,5,4,0,61,57,1244,58,1125,4,4,0,11,42,155,55,34,1,0,0,50,15
250251404006,1618,333,997,5,21,1,170,91,1202,209,914,2,21,1,4,51,416,124,83,3,0,0,166,40
250251404007,1172,395,519,12,38,3,170,35,826,275,475,6,37,3,8,22,346,120,44,6,1,0,162,13
250251601011,1332,577,85,7,23,0,584,56,190,107,49,0,22,0,4,8,1142,470,36,7,1,0,580,48
250251601012,1372,561,128,48,32,0,521,82,387,223,85,1,32,0,29,17,985,338,43,47,0,0,492,65
250251601013,1730,867,111,1,62,0,622,67,685,504,93,0,62,0,9,17,1045,363,18,1,0,0,613,50
250251601014,2092,663,223,52,32,0,960,162,457,159,167,10,32,0,49,40,1635,504,56,42,0,0,911,122
250251601015,1025,428,53,17,8,0,469,50,117,66,35,1,4,0,8,3,908,362,18,16,4,0,461,47
250251602001,1336,325,62,12,19,0,857,61,172,87,42,1,18,0,15,9,1164,238,20,11,1,0,842,52
250251602002,1210,385,74,14,8,1,624,104,188,89,57,2,8,0,7,25,1022,296,17,12,0,1,617,79
250251602003,1497,522,95,8,24,0,775,73,336,215,77,0,24,0,10,10,1161,307,18,8,0,0,765,63
250251603001,1469,1137,131,5,24,0,109,63,1167,984,121,0,23,0,4,35,302,153,10,5,1,0,105,28
250251603002,596,414,49,4,15,0,86,28,437,359,40,2,15,0,0,21,159,55,9,2,0,0,86,7
250251604001,933,431,59,5,60,0,334,44,283,156,52,1,57,0,7,10,650,275,7,4,3,0,327,34
250251604002,1783,625,234,21,53,0,706,144,511,244,182,1,49,0,8,27,1272,381,52,20,4,0,698,117
250251605011,2097,959,188,27,70,0,710,143,557,282,152,3,66,0,18,36,1540,677,36,24,4,0,692,107
250251605012,1231,581,76,18,26,0,452,78,375,235,75,0,26,0,11,28,856,346,1,18,0,0,441,50
250251605013,774,296,72,13,8,0,325,60,179,113,40,0,8,0,0,18,595,183,32,13,0,0,325,42
250251605014,754,353,59,7,34,0,241,60,253,165,30,2,33,0,4,19,501,188,29,5,1,0,237,41
250251605015,748,366,80,21,26,0,192,63,284,154,67,9,22,0,3,29,464,212,13,12,4,0,189,34
250251605021,1703,849,83,14,55,0,599,103,636,478,46,7,53,0,20,32,1067,371,37,7,2,0,579,71
250251605022,1359,737,103,8,50,0,366,95,551,376,80,0,50,0,18,27,808,361,23,8,0,0,348,68
250251605023,1398,597,141,7,63,0,467,123,523,300,104,2,59,0,4,54,875,297,37,5,4,0,463,69
250251606011,2158,1306,182,14,123,0,437,96,1134,795,148,6,117,0,37,31,1024,511,34,8,6,0,400,65
250251606012,1905,1175,226,11,55,6,355,77,1207,906,180,2,51,2,42,24,698,269,46,9,4,4,313,53
250251606021,1290,661,166,19,57,0,287,100,697,426,153,1,56,0,47,14,593,235,13,18,1,0,240,86
250251606022,795,501,84,3,15,0,172,20,494,376,78,0,13,0,24,3,301,125,6,3,2,0,148,17
250251606023,825,585,43,2,40,0,114,41,588,481,36,2,40,0,18,11,237,104,7,0,0,0,96,30
250251606024,780,345,101,9,32,0,256,37,319,178,88,2,32,0,10,9,461,167,13,7,0,0,246,28
250251606025,985,586,78,3,80,0,206,32,595,424,64,0,80,0,17,10,390,162,14,3,0,0,189,22
250251701001,1671,1208,93,0,129,3,170,68,1357,1098,71,0,127,0,27,34,314,110,22,0,2,3,143,34
250251701002,1012,738,23,4,47,0,159,41,769,644,14,3,47,0,39,22,243,94,9,1,0,0,120,19
250251701003,773,538,72,2,22,0,116,23,536,413,68,1,21,0,18,15,237,125,4,1,1,0,98,8
250251701004,727,561,43,4,17,0,80,22,556,480,36,0,17,0,9,14,171,81,7,4,0,0,71,8
250251701005,1320,1030,56,9,58,3,139,25,1003,870,42,0,58,3,14,16,317,160,14,9,0,0,125,9
250251701006,722,579,25,3,27,0,68,20,583,516,24,1,27,0,9,6,139,63,1,2,0,0,59,14
250251701007,1335,791,95,14,47,1,325,62,749,589,76,2,47,1,14,20,586,202,19,12,0,0,311,42
250251702001,1228,995,46,2,44,0,95,46,1022,894,44,1,44,0,10,29,206,101,2,1,0,0,85,17
250251702002,1395,965,55,5,91,0,209,70,1069,853,50,5,91,0,32,38,326,112,5,0,0,0,177,32
250251702003,606,501,39,6,3,0,48,9,484,434,36,1,3,0,7,3,122,67,3,5,0,0,41,6
250251702004,1335,1134,20,0,65,0,107,9,1143,1044,20,0,65,0,7,7,192,90,0,0,0,0,100,2
250251703001,1956,1344,201,4,225,0,94,88,1674,1177,190,3,225,0,14,65,282,167,11,1,0,0,80,23
250251703002,899,643,97,2,66,0,53,38,787,579,95,2,66,0,24,21,112,64,2,0,0,0,29,17
250251703003,946,750,34,3,61,0,76,22,826,701,33,3,60,0,21,8,120,49,1,0,1,0,55,14
250251703004,1609,1362,44,0,80,1,94,28,1458,1291,42,0,75,1,29,20,151,71,2,0,5,0,65,8
250251703005,1692,1444,43,1,52,0,137,15,1466,1336,37,0,47,0,33,13,226,108,6,1,5,0,104,2
250251703006,1209,1022,48,0,15,0,100,24,1003,901,48,0,15,0,22,17,206,121,0,0,0,0,78,7
250251703007,729,618,20,4,15,0,51,21,606,548,20,3,15,0,7,13,123,70,0,1,0,0,44,8
250251704001,1102,918,50,1,18,0,89,26,865,779,41,0,18,0,9,18,237,139,9,1,0,0,80,8
250251704002,1151,899,59,2,52,0,113,26,934,792,52,2,52,0,19,17,217,107,7,0,0,0,94,9
250251704003,1101,751,46,8,51,1,188,56,731,608,39,0,50,0,12,22,370,143,7,8,1,1,176,34
250251704004,2025,1439,181,8,120,1,187,89,1643,1254,167,3,119,0,55,45,382,185,14,5,1,1,132,44
250251705011,1934,1477,103,7,116,0,158,73,1465,1196,85,0,116,0,30,38,469,281,18,7,0,0,128,35
250251705012,1501,1187,52,4,75,0,141,42,1156,998,48,2,69,0,18,21,345,189,4,2,6,0,123,21
250251705021,1134,1049,21,4,25,0,25,10,1050,992,20,2,25,0,5,6,84,57,1,2,0,0,20,4
250251705022,1684,1458,59,11,51,0,54,51,1502,1348,54,7,51,0,13,29,182,110,5,4,0,0,41,22
250251706011,1351,1031,45,3,33,0,196,43,1017,909,40,3,30,0,16,19,334,122,5,0,3,0,180,24
250251706012,1413,1084,24,1,59,0,200,45,997,884,18,1,59,0,17,18,416,200,6,0,0,0,183,27
250251706013,1387,923,58,5,67,0,289,45,906,734,47,5,67,0,31,22,481,189,11,0,0,0,258,23
250251706014,954,695,16,6,32,0,164,41,670,596,12,0,30,0,14,18,284,99,4,6,2,0,150,23
250251707011,788,660,31,3,14,0,51,29,613,541,25,3,14,0,10,20,175,119,6,0,0,0,41,9
250251707012,1311,978,69,5,82,1,139,37,948,781,59,1,81,1,7,18,363,197,10,4,1,0,132,19
250251707021,1146,516,91,6,199,0,289,45,567,248,81,4,198,0,22,14,579,268,10,2,1,0,267,31
250277392003,1365,873,42,5,305,0,88,52,1305,839,39,3,305,0,74,45,60,34,3,2,0,0,14,7
250277392004,1765,1284,21,1,420,0,26,13,1704,1238,18,0,420,0,17,11,61,46,3,1,0,0,9,2
250277393001,1623,1460,8,1,120,0,1,33,1600,1441,8,1,120,0,0,30,23,19,0,0,0,0,1,3
250277393002,2065,1641,63,4,270,0,47,40,1982,1585,63,4,266,0,28,36,83,56,0,0,4,0,19,4
250277394001,1448,1203,11,0,211,0,1,22,1419,1175,11,0,211,0,0,22,29,28,0,0,0,0,1,0
250277394002,1805,1665,6,0,91,0,14,29,1783,1653,2,0,91,0,8,29,22,12,4,0,0,0,6,0
250277394003,2174,1904,24,4,220,0,5,17,2134,1874,21,1,220,0,3,15,40,30,3,3,0,0,2,2
250277394004,2064,1693,41,1,262,0,24,43,2024,1673,41,1,262,0,9,38,40,20,0,0,0,0,15,5
250277394005,1360,784,71,0,405,0,52,48,1298,743,70,0,405,0,33,47,62,41,1,0,0,0,19,1
250277395001,2979,2569,20,1,324,0,12,53,2928,2527,16,1,324,0,10,50,51,42,4,0,0,0,2,3
250277395002,756,660,16,0,67,0,4,9,742,651,15,0,67,0,1,8,14,9,1,0,0,0,3,1
250277395003,2791,2510,37,1,195,0,24,24,2739,2473,35,1,195,0,14,21,52,37,2,0,0,0,10,3
250277395004,1028,908,6,1,77,0,21,15,972,865,6,1,77,0,9,14,56,43,0,0,0,0,12,1
250277401011,1546,1343,18,0,127,0,29,29,1503,1314,17,0,127,0,16,29,43,29,1,0,0,0,13,0
250277401012,1880,1602,10,5,204,0,13,46,1853,1587,10,4,204,0,4,44,27,15,0,1,0,0,9,2
250277401013,1765,1587,16,4,105,0,18,35,1716,1562,16,1,103,0,1,33,49,25,0,3,2,0,17,2
250277401021,2755,2434,29,0,220,2,29,41,2674,2384,22,0,220,2,5,41,81,50,7,0,0,0,24,0
250277401022,1588,1339,22,2,169,0,17,39,1546,1308,21,2,168,0,13,34,42,31,1,0,1,0,4,5
250277401023,1710,1568,9,3,104,0,4,22,1655,1527,9,1,102,0,0,16,55,41,0,2,2,0,4,6
250277402001,745,628,15,0,78,0,9,15,712,609,11,0,78,0,0,14,33,19,4,0,0,0,9,1
250277402002,1222,1068,14,0,95,1,5,39,1196,1053,12,0,95,0,4,32,26,15,2,0,0,1,1,7
250277402003,944,836,9,2,56,0,8,33,919,816,9,2,56,0,4,32,25,20,0,0,0,0,4,1
250277411011,854,763,14,1,60,0,7,9,828,739,14,1,60,0,6,8,26,24,0,0,0,0,1,1
250277411012,1939,1724,18,6,140,0,14,37,1904,1701,16,6,140,0,9,32,35,23,2,0,0,0,5,5
250277411013,1685,1514,15,4,122,1,13,16,1615,1461,10,4,122,0,3,15,70,53,5,0,0,1,10,1
250277411021,1146,1024,2,0,82,0,5,33,1115,1000,2,0,82,0,1,30,31,24,0,0,0,0,4,3
250277411022,1828,1575,23,5,173,0,9,43,1785,1551,22,2,171,0,4,35,43,24,1,3,2,0,5,8
250277411023,989,875,7,0,81,0,10,16,967,855,7,0,81,0,9,15,22,20,0,0,0,0,1,1
250277411024,1326,1130,10,0,157,0,6,23,1281,1098,9,0,157,0,4,13,45,32,1,0,0,0,2,10
250277423001,996,866,20,4,57,0,24,25,937,838,13,3,57,0,7,19,59,28,7,1,0,0,17,6
250277423002,815,734,10,2,36,0,22,11,791,727,7,2,36,0,9,10,24,7,3,0,0,0,13,1
250277423003,732,699,2,0,16,0,6,9,718,689,2,0,16,0,3,8,14,10,0,0,0,0,3,1
250277423004,773,649,8,0,48,0,49,19,695,621,5,0,48,0,14,7,78,28,3,0,0,0,35,12
250277423005,729,544,14,0,114,0,45,12,653,512,14,0,110,0,8,9,76,32,0,0,4,0,37,3
250277424011,2950,2625,21,2,251,0,2,49,2909,2587,21,1,251,0,1,48,41,38,0,1,0,0,1,1
250277424012,2471,2112,20,2,281,0,13,43,2424,2078,18,2,281,0,4,41,47,34,2,0,0,0,9,2
250277424021,1819,725,26,7,993,0,43,25,1751,695,26,6,990,0,11,23,68,30,0,1,3,0,32,2
250277424022,1207,1037,4,1,146,0,6,13,1177,1019,4,1,146,0,0,7,30,18,0,0,0,0,6,6
250277431001,2245,2108,11,2,80,0,6,38,2211,2083,11,1,80,0,2,34,34,25,0,1,0,0,4,4
250277431002,2246,2175,18,2,25,0,3,23,2209,2141,18,2,25,0,0,23,37,34,0,0,0,0,3,0
250277431003,908,844,8,6,32,0,6,12,883,836,5,1,32,0,0,9,25,8,3,5,0,0,6,3
250277431004,2143,2061,20,2,25,1,4,30,2120,2045,18,0,25,1,4,27,23,16,2,2,0,0,0,3
250277441011,1151,1084,9,1,38,0,0,19,1114,1048,9,1,38,0,0,18,37,36,0,0,0,0,0,1
250277441012,1370,1156,38,2,84,0,34,56,1315,1126,37,1,84,0,13,54,55,30,1,1,0,0,21,2
250277441013,1565,1443,33,1,23,0,33,32,1496,1393,31,0,23,0,17,32,69,50,2,1,0,0,16,0
250277441014,1566,1337,37,2,83,0,44,63,1447,1259,35,2,83,0,20,48,119,78,2,0,0,0,24,15
250277441015,1793,1688,18,0,59,1,8,19,1764,1666,17,0,59,1,4,17,29,22,1,0,0,0,4,2
250277441021,2503,2183,91,5,42,0,97,85,2297,2067,68,5,42,0,46,69,206,116,23,0,0,0,51,16
250277441022,2755,2597,48,2,47,0,30,31,2671,2542,42,1,46,0,13,27,84,55,6,1,1,0,17,4
250277442001,1193,930,32,9,30,3,146,43,1032,881,27,2,27,0,56,39,161,49,5,7,3,3,90,4
250277442002,921,802,14,3,21,0,62,19,812,730,13,3,21,0,33,12,109,72,1,0,0,0,29,7
250277442003,2824,2558,40,8,84,0,104,30,2671,2468,32,7,84,0,52,28,153,90,8,1,0,0,52,2
250277442004,1813,1512,45,0,47,0,151,58,1656,1445,44,0,47,0,78,42,157,67,1,0,0,0,73,16
250277442005,733,674,4,0,19,0,21,15,689,641,4,0,19,0,16,9,44,33,0,0,0,0,5,6
250277443001,1010,813,37,14,0,0,105,41,833,723,34,3,0,0,46,27,177,90,3,11,0,0,59,14
250277443002,1117,811,25,11,17,0,210,43,907,718,25,3,17,0,110,34,210,93,0,8,0,0,100,9
250277443003,805,650,25,0,4,0,93,33,626,535,16,0,1,0,47,27,179,115,9,0,3,0,46,6
250277443004,906,775,27,9,13,0,41,41,783,693,25,3,13,0,18,31,123,82,2,6,0,0,23,10
250277444001,1130,1023,11,1,15,0,43,37,1056,972,11,1,15,0,33,24,74,51,0,0,0,0,10,13
250277444002,1641,1451,21,0,43,1,62,63,1501,1374,21,0,43,1,13,49,140,77,0,0,0,0,49,14
250277444003,1203,906,56,1,12,1,186,41,1014,823,44,1,12,0,101,33,189,83,12,0,0,1,85,8
250277451001,2555,2430,19,3,30,1,25,47,2494,2400,18,2,30,1,12,31,61,30,1,1,0,0,13,16
250277451002,1359,1316,7,0,14,0,13,9,1332,1299,7,0,14,0,3,9,27,17,0,0,0,0,10,0
250277451003,1997,1894,11,2,57,0,10,23,1958,1862,11,2,57,0,3,23,39,32,0,0,0,0,7,0
250277461001,1713,1661,4,0,24,0,10,14,1693,1653,4,0,24,0,0,12,20,8,0,0,0,0,10,2
250277461002,1258,1222,4,1,10,1,7,13,1248,1215,3,1,10,1,5,13,10,7,1,0,0,0,2,0
250277461003,2868,2791,14,1,23,1,11,27,2825,2763,10,1,23,1,0,27,43,28,4,0,0,0,11,0
250277471011,2858,2761,40,5,8,1,6,37,2808,2719,38,5,8,1,1,36,50,42,2,0,0,0,5,1
250277471012,1121,1090,9,2,8,0,2,10,1102,1072,9,2,8,0,1,10,19,18,0,0,0,0,1,0
250277471013,1131,1080,8,6,17,0,2,18,1102,1057,7,6,17,0,0,15,29,23,1,0,0,0,2,3
250277471021,1962,1910,11,4,15,0,2,20,1938,1887,11,3,15,0,2,20,24,23,0,1,0,0,0,0
250277471022,1954,1863,14,5,23,2,16,31,1891,1820,12,5,23,2,1,28,63,43,2,0,0,0,15,3
250277481001,1790,1731,10,7,25,0,1,16,1766,1709,9,7,25,0,0,16,24,22,1,0,0,0,1,0
250277481002,1400,1374,5,0,4,0,3,14,1383,1364,4,0,4,0,0,11,17,10,1,0,0,0,3,3
250277491001,1834,1738,16,6,45,0,4,25,1808,1719,16,0,45,0,3,25,26,19,0,6,0,0,1,0
250277491002,2742,2647,23,1,13,1,24,33,2672,2610,17,0,13,1,2,29,70,37,6,1,0,0,22,4
250277491003,2016,1920,21,2,23,0,15,35,1981,1896,19,0,23,0,9,34,35,24,2,2,0,0,6,1
250277491004,1396,1355,11,1,15,0,0,14,1383,1343,11,1,15,0,0,13,13,12,0,0,0,0,0,1
250277492001,2426,2331,25,5,12,1,10,42,2374,2292,23,5,12,1,5,36,52,39,2,0,0,0,5,6
250277492002,3043,2943,15,4,32,0,9,40,2982,2896,15,1,32,0,5,33,61,47,0,3,0,0,4,7
250277501001,1372,1303,23,1,12,1,0,32,1345,1283,17,1,12,1,0,31,27,20,6,0,0,0,0,1
250277501002,2755,2583,18,8,34,0,53,59,2602,2494,14,8,34,0,3,49,153,89,4,0,0,0,50,10
250277501003,1921,1859,13,1,14,0,15,19,1857,1809,13,1,14,0,2,18,64,50,0,0,0,0,13,1
250277502001,698,681,0,1,13,0,0,3,691,674,0,1,13,0,0,3,7,7,0,0,0,0,0,0
250277502002,2194,2117,23,2,12,0,8,32,2145,2083,22,2,12,0,0,26,49,34,1,0,0,0,8,6
250277502003,1330,1295,2,0,16,0,2,15,1312,1282,2,0,16,0,1,11,18,13,0,0,0,0,1,4
250277502004,2527,2444,10,4,34,0,11,24,2483,2409,7,4,34,0,10,19,44,35,3,0,0,0,1,5
250277503001,2910,2789,23,6,24,0,17,51,2781,2686,21,5,24,0,1,44,129,103,2,1,0,0,16,7
250277511011,2852,2756,22,0,23,5,6,40,2829,2735,22,0,23,5,4,40,23,21,0,0,0,0,2,0
250277511012,2441,2377,6,0,34,1,3,20,2407,2346,6,0,34,1,1,19,34,31,0,0,0,0,2,1
250277511013,926,891,5,6,8,0,2,14,906,878,5,1,8,0,0,14,20,13,0,5,0,0,2,0
250277511021,1496,1452,5,3,12,1,1,22,1481,1441,5,0,12,1,0,22,15,11,0,3,0,0,1,0
250277511022,1248,1215,1,3,7,1,8,13,1225,1204,0,2,7,1,3,8,23,11,1,1,0,0,5,5
250277521001,2076,2017,15,4,16,1,2,21,2052,2003,7,4,16,1,2,19,24,14,8,0,0,0,0,2
250277521002,2557,2455,16,3,14,2,6,61,2512,2422,15,3,13,2,3,54,45,33,1,0,1,0,3,7
250277521003,1068,1028,8,1,13,0,8,10,1057,1023,7,0,13,0,4,10,11,5,1,1,0,0,4,0
250277521004,2770,2681,6,7,33,0,3,40,2711,2626,6,7,33,0,0,39,59,55,0,0,0,0,3,1
250277531001,741,707,13,0,17,0,3,1,729,702,10,0,17,0,0,0,12,5,3,0,0,0,3,1
250277531002,1151,1119,1,1,14,1,7,8,1111,1086,1,1,14,1,0,8,40,33,0,0,0,0,7,0
250277531003,1896,1848,8,4,16,0,3,17,1865,1824,8,4,15,0,0,14,31,24,0,0,1,0,3,3
250277531004,1826,1752,21,2,13,1,6,31,1786,1718,21,2,13,1,2,29,40,34,0,0,0,0,4,2
250277531005,1844,1609,60,3,27,0,93,52,1646,1518,55,1,27,0,7,38,198,91,5,2,0,0,86,14
250277532001,2059,1997,8,1,20,1,9,23,2018,1969,8,0,20,0,1,20,41,28,0,1,0,1,8,3
250277532002,2978,2874,18,4,18,0,21,43,2902,2832,17,2,18,0,0,33,76,42,1,2,0,0,21,10
250277532003,1214,1160,14,6,17,0,6,11,1188,1142,14,6,17,0,0,9,26,18,0,0,0,0,6,2
250277541001,1337,1280,13,1,16,0,12,15,1306,1265,13,1,14,0,1,12,31,15,0,0,2,0,11,3
250277541002,1813,1710,23,3,28,0,20,29,1750,1669,22,3,28,0,7,21,63,41,1,0,0,0,13,8
250277541003,1672,1630,6,3,18,0,9,6,1645,1611,6,3,18,0,1,6,27,19,0,0,0,0,8,0
250277541004,1680,1556,27,3,21,0,26,47,1579,1502,25,2,17,0,3,30,101,54,2,1,4,0,23,17
250277542001,2074,1748,134,10,25,0,111,46,1826,1636,110,10,25,0,13,32,248,112,24,0,0,0,98,14
250277542002,1388,1279,27,12,9,0,19,42,1290,1217,20,11,9,0,0,33,98,62,7,1,0,0,19,9
250277543001,901,770,40,4,14,0,42,31,786,703,38,3,14,0,3,25,115,67,2,1,0,0,39,6
250277543002,2059,1770,102,3,33,0,88,63,1796,1604,95,3,33,0,14,47,263,166,7,0,0,0,74,16
250277544001,1097,1042,21,1,2,0,11,20,1072,1034,19,1,2,0,0,16,25,8,2,0,0,0,11,4
250277544002,982,945,14,1,7,0,4,11,955,924,13,0,7,0,2,9,27,21,1,1,0,0,2,2
250277544003,1764,1563,75,9,11,0,50,56,1614,1493,59,9,11,0,7,35,150,70,16,0,0,0,43,21
250277551001,1643,1556,21,2,13,1,17,33,1580,1516,20,1,13,1,2,27,63,40,1,1,0,0,15,6
250277551002,1657,1565,26,4,11,0,27,24,1588,1528,24,4,11,0,1,20,69,37,2,0,0,0,26,4
250277552001,1181,1151,9,1,10,0,0,10,1159,1135,8,1,10,0,0,5,22,16,1,0,0,0,0,5
250277552002,2075,1993,11,4,22,0,15,30,2015,1960,5,2,20,0,0,28,60,33,6,2,2,0,15,2
250277552003,1140,1096,14,1,6,0,13,10,1118,1083,14,1,6,0,4,10,22,13,0,0,0,0,9,0
250277552004,2621,2507,40,2,19,0,25,28,2552,2464,33,2,19,0,12,22,69,43,7,0,0,0,13,6
250277552005,1073,1008,15,2,14,0,6,28,1048,996,14,2,14,0,0,22,25,12,1,0,0,0,6,6
250277561011,2151,2063,16,2,21,0,13,36,2110,2035,16,2,21,0,4,32,41,28,0,0,0,0,9,4
250277561012,2361,2256,25,2,29,1,16,32,2287,2205,24,2,28,0,5,23,74,51,1,0,1,1,11,9
250277561021,2960,2842,19,5,29,6,16,43,2880,2792,16,2,26,6,0,38,80,50,3,3,3,0,16,5
250277561022,3353,3235,23,6,33,1,14,41,3276,3186,17,6,31,1,2,33,77,49,6,0,2,0,12,8
250277561023,2156,2092,7,8,8,1,9,31,2054,2015,2,8,8,1,0,20,102,77,5,0,0,0,9,11
250277571001,1246,1042,41,0,23,0,120,20,905,844,25,0,22,0,7,7,341,198,16,0,1,0,113,13
250277571002,1653,1292,49,21,52,1,178,60,1186,1068,38,17,48,1,0,14,467,224,11,4,4,0,178,46
250277571003,902,772,26,5,24,0,58,17,700,657,4,5,24,0,0,10,202,115,22,0,0,0,58,7
250277571004,713,569,9,6,8,0,92,29,533,504,0,5,8,0,0,16,180,65,9,1,0,0,92,13
250277572001,926,681,45,1,16,0,128,55,534,482,24,1,12,0,0,15,392,199,21,0,4,0,128,40
250277572002,601,465,19,1,19,0,83,14,328,301,5,0,19,0,0,3,273,164,14,1,0,0,83,11
250277572003,766,552,11,0,15,0,150,38,449,406,11,0,15,0,0,17,317,146,0,0,0,0,150,21
250277573001,1211,988,41,14,9,0,140,19,899,860,18,4,9,0,0,8,312,128,23,10,0,0,140,11
250277573002,1660,1031,50,20,39,0,452,68,808,728,13,11,35,0,1,20,852,303,37,9,4,0,451,48
250277574001,766,692,17,0,13,0,27,17,641,605,16,0,12,0,0,8,125,87,1,0,1,0,27,9
250277574002,625,577,3,0,5,0,34,6,553,544,2,0,5,0,1,1,72,33,1,0,0,0,33,5
250277574003,1316,1101,29,7,11,1,128,39,1059,991,22,7,11,1,3,24,257,110,7,0,0,0,125,15
250277575001,1504,1253,59,7,17,0,120,48,1180,1095,40,3,17,0,3,22,324,158,19,4,0,0,117,26
250277575002,882,810,4,3,18,0,26,21,769,730,4,3,18,0,2,12,113,80,0,0,0,0,24,9
250277575003,744,646,15,3,15,0,51,14,634,602,9,2,15,0,0,6,110,44,6,1,0,0,51,8
250277575004,1204,1109,13,0,26,1,36,19,1089,1048,5,0,26,1,1,8,115,61,8,0,0,0,35,11
250277581011,1650,1613,7,0,10,0,6,14,1629,1598,7,0,10,0,0,14,21,15,0,0,0,0,6,0
250277581021,1579,1477,14,5,43,0,18,22,1520,1434,14,5,43,0,4,20,59,43,0,0,0,0,14,2
250277581022,1897,1820,12,2,36,0,3,24,1859,1789,12,2,36,0,1,19,38,31,0,0,0,0,2,5
250277581023,1239,1172,5,2,34,0,11,15,1211,1152,5,2,34,0,3,15,28,20,0,0,0,0,8,0
250277581024,1379,1292,12,12,17,0,21,25,1339,1279,12,11,17,0,3,17,40,13,0,1,0,0,18,8
250277581025,1524,1442,6,4,44,0,11,17,1479,1413,6,3,44,0,1,12,45,29,0,1,0,0,10,5
250277591001,1323,1282,8,2,3,0,7,21,1288,1254,8,2,3,0,1,20,35,28,0,0,0,0,6,1
250277591002,860,839,3,3,3,0,0,12,844,825,3,3,3,0,0,10,16,14,0,0,0,0,0,2
250277601001,891,867,2,2,1,0,3,16,880,859,2,2,1,0,0,16,11,8,0,0,0,0,3,0
250277601002,1555,1513,4,2,4,0,0,32,1538,1497,4,1,4,0,0,32,17,16,0,1,0,0,0,0
250277601003,944,919,4,1,2,0,1,17,928,909,4,0,2,0,0,13,16,10,0,1,0,0,1,4
250277611001,1296,1263,3,1,7,1,2,19,1266,1243,2,1,7,1,0,12,30,20,1,0,0,0,2,7
250277611002,1104,1056,3,6,9,1,7,22,1076,1039,3,6,8,1,0,19,28,17,0,0,1,0,7,3
250277611003,1036,1004,8,0,0,0,6,18,1004,979,8,0,0,0,0,17,32,25,0,0,0,0,6,1
250277611004,1699,1648,16,4,2,0,3,26,1669,1632,16,3,2,0,3,13,30,16,0,1,0,0,0,13
250277612001,2106,1535,37,1,453,1,27,52,2047,1490,35,1,453,1,16,51,59,45,2,0,0,0,11,1
250277612002,1935,1109,62,7,675,2,28,52,1810,1027,42,7,675,2,15,42,125,82,20,0,0,0,13,10
250277612003,1739,1508,49,4,118,1,21,38,1643,1440,44,3,118,1,0,37,96,68,5,1,0,0,21,1
250277613001,862,816,7,1,23,0,1,14,854,811,6,1,23,0,1,12,8,5,1,0,0,0,0,2
250277613002,937,869,8,2,31,0,10,17,910,850,8,2,31,0,4,15,27,19,0,0,0,0,6,2
250277613003,1260,1178,19,2,31,0,9,21,1216,1141,18,2,31,0,3,21,44,37,1,0,0,0,6,0
250277614001,1042,970,1,1,31,0,2,37,1021,960,1,1,31,0,0,28,21,10,0,0,0,0,2,9
250277614002,1155,1101,7,0,27,3,2,15,1140,1088,7,0,27,3,0,15,15,13,0,0,0,0,2,0
250277614003,988,926,1,2,30,0,3,26,953,899,1,0,30,0,2,21,35,27,0,2,0,0,1,5
250277614004,737,702,0,0,21,0,1,13,726,693,0,0,21,0,0,12,11,9,0,0,0,0,1,1
250277614005,1141,1034,11,1,66,0,1,28,1125,1021,11,0,66,0,0,27,16,13,0,1,0,0,1,1
250277614006,1457,1154,244,0,42,0,12,5,1291,1007,239,0,42,0,0,3,166,147,5,0,0,0,12,2
250277311022,896,616,97,2,88,0,61,32,743,543,85,1,88,0,2,24,153,73,12,1,0,0,59,8
250277311023,761,601,64,1,31,0,31,33,690,580,56,1,31,0,1,21,71,21,8,0,0,0,30,12
250277312021,1111,880,43,0,112,0,20,56,1052,853,37,0,112,0,5,45,59,27,6,0,0,0,15,11
250277312031,1742,992,204,12,242,1,218,73,1130,685,162,7,242,1,10,23,612,307,42,5,0,0,208,50
250277312032,1133,707,109,12,151,2,118,34,813,542,93,2,151,0,3,22,320,165,16,10,0,2,115,12
250277312033,1371,717,155,9,150,5,237,98,769,439,114,7,150,1,22,36,602,278,41,2,0,4,215,62
250277312034,952,530,118,9,68,0,187,40,520,337,85,3,68,0,10,17,432,193,33,6,0,0,177,23
250277312041,1515,787,163,12,222,0,243,88,902,501,128,5,221,0,3,44,613,286,35,7,1,0,240,44
250277312042,983,438,178,12,74,0,233,48,476,242,144,2,74,0,0,14,507,196,34,10,0,0,233,34
250277313001,1154,442,181,3,192,0,228,108,632,247,150,0,191,0,6,38,522,195,31,3,1,0,222,70
250277313002,1182,463,152,3,161,0,320,83,564,255,115,1,159,0,6,28,618,208,37,2,2,0,314,55
250277313003,1505,621,173,10,135,1,460,105,638,326,133,6,135,0,5,33,867,295,40,4,0,1,455,72
250277314001,947,428,143,8,13,0,281,74,297,156,105,1,9,0,1,25,650,272,38,7,4,0,280,49
250277314002,722,239,120,9,49,1,252,52,296,114,89,8,48,1,15,21,426,125,31,1,1,0,237,31
250277314003,1052,457,158,5,105,3,267,57,553,283,133,4,105,0,5,23,499,174,25,1,0,3,262,34
250277314004,1313,605,250,10,149,0,248,51,680,246,227,8,147,0,20,32,633,359,23,2,2,0,228,19
250277314005,639,313,128,6,58,0,72,62,419,198,110,6,58,0,1,46,220,115,18,0,0,0,71,16
250277315001,630,324,77,7,16,0,178,28,225,130,56,5,16,0,5,13,405,194,21,2,0,0,173,15
250277315002,1027,571,217,5,22,0,178,34,574,377,154,3,21,0,2,17,453,194,63,2,1,0,176,17
250277315003,1374,654,284,14,70,0,288,64,645,314,217,8,69,0,4,33,729,340,67,6,1,0,284,31
250277315004,881,308,168,23,67,5,255,55,442,184,129,21,65,0,11,32,439,124,39,2,2,5,244,23
250277315005,1262,773,145,5,91,0,192,56,869,596,128,5,89,0,15,36,393,177,17,0,2,0,177,20
250277316001,1480,1082,101,5,160,1,79,52,1331,1025,87,4,160,0,14,41,149,57,14,1,0,1,65,11
250277316002,806,447,105,4,81,0,143,26,533,323,86,4,81,0,15,24,273,124,19,0,0,0,128,2
250277316003,1267,850,183,1,48,2,122,61,1026,734,169,1,46,1,36,39,241,116,14,0,2,1,86,22
250277316004,1410,1083,75,2,164,2,45,39,1273,1007,68,2,161,1,3,31,137,76,7,0,3,1,42,8
250277316005,884,584,90,6,69,1,92,42,738,529,81,5,68,1,25,29,146,55,9,1,1,0,67,13
250277316006,1510,1242,42,5,178,0,13,30,1405,1155,40,4,178,0,2,26,105,87,2,1,0,0,11,4
250277317001,1772,1134,292,4,127,0,154,61,1337,880,262,2,127,0,17,49,435,254,30,2,0,0,137,12
250277317002,989,587,180,11,34,0,127,50,665,437,158,6,32,0,4,28,324,150,22,5,2,0,123,22
250277318001,793,552,59,3,61,1,74,43,662,498,54,3,61,0,16,30,131,54,5,0,0,1,58,13
250277318002,804,478,101,0,22,0,135,68,526,379,66,0,22,0,20,39,278,99,35,0,0,0,115,29
250277318003,1536,730,289,24,36,0,361,96,423,145,206,3,32,0,10,27,1113,585,83,21,4,0,351,69
250277318004,937,410,192,2,105,0,148,80,611,269,176,2,105,0,13,46,326,141,16,0,0,0,135,34
250277318005,639,436,85,2,6,0,75,35,433,316,77,0,6,0,8,26,206,120,8,2,0,0,67,9
250277318006,1463,1171,71,3,42,0,99,77,1222,1028,57,2,42,0,41,52,241,143,14,1,0,0,58,25
250277319001,1068,532,253,3,51,0,171,58,655,355,212,1,51,0,9,27,413,177,41,2,0,0,162,31
250277319002,1191,677,243,15,32,0,160,64,759,464,221,14,26,0,5,29,432,213,22,1,6,0,155,35
250277319003,709,379,158,4,18,0,115,35,440,232,148,2,18,0,18,22,269,147,10,2,0,0,97,13
250277319004,2259,1166,546,34,104,0,306,103,1413,723,485,22,97,0,21,65,846,443,61,12,7,0,285,38
250277320011,3327,1487,540,17,107,0,858,318,1084,520,372,10,96,0,7,79,2243,967,168,7,11,0,851,239
250277320021,1227,808,203,0,104,0,58,54,988,644,189,0,104,0,14,37,239,164,14,0,0,0,44,17
250277320022,2291,1689,211,7,243,2,78,61,2082,1566,199,4,243,2,19,49,209,123,12,3,0,0,59,12
250277320023,518,488,17,0,1,0,8,4,495,478,15,0,1,0,0,1,23,10,2,0,0,0,8,3
250277322011,788,664,31,2,39,0,25,27,722,635,27,1,39,0,5,15,66,29,4,1,0,0,20,12
250277322012,2032,1437,211,2,217,0,112,53,1878,1351,196,1,217,0,69,44,154,86,15,1,0,0,43,9
250277322021,1073,782,87,8,107,0,66,23,948,737,77,3,107,0,8,16,125,45,10,5,0,0,58,7
250277322022,954,840,34,2,23,0,28,27,884,805,30,1,23,0,7,18,70,35,4,1,0,0,21,9
250277322023,1213,835,108,14,62,6,126,62,1014,768,95,3,62,6,41,39,199,67,13,11,0,0,85,23
250277322031,944,544,95,0,246,0,20,39,873,506,92,0,246,0,2,27,71,38,3,0,0,0,18,12
250277322032,1040,719,96,4,42,0,125,54,779,616,79,4,42,0,4,34,261,103,17,0,0,0,121,20
250277322033,869,587,154,7,18,3,62,38,610,394,146,1,18,2,20,29,259,193,8,6,0,1,42,9
250277323011,2131,1744,156,0,120,0,67,44,1973,1661,153,0,120,0,9,30,158,83,3,0,0,0,58,14
250277323012,1285,956,148,3,107,0,26,45,1154,872,146,3,107,0,2,24,131,84,2,0,0,0,24,21
250277323013,739,672,22,1,15,0,10,19,703,647,18,1,15,0,5,17,36,25,4,0,0,0,5,2
250277323021,2371,1638,274,2,70,0,233,154,1840,1387,247,1,70,0,34,101,531,251,27,1,0,0,199,53
250277323022,1531,1143,219,0,55,0,67,47,1393,1087,202,0,53,0,11,40,138,56,17,0,2,0,56,7
250277324001,1096,649,191,2,52,0,132,70,770,497,149,2,52,0,20,50,326,152,42,0,0,0,112,20
250277324002,1244,699,285,4,85,3,112,56,897,502,252,4,85,0,14,40,347,197,33,0,0,3,98,16
250277324003,1060,600,211,3,29,11,127,79,601,373,155,2,26,10,4,31,459,227,56,1,3,1,123,48
250277324004,910,514,145,10,13,0,191,37,470,318,119,3,13,0,6,11,440,196,26,7,0,0,185,26
250277324005,815,395,106,7,47,0,193,67,426,230,99,6,47,0,17,27,389,165,7,1,0,0,176,40
250277324006,1334,756,239,0,82,6,180,71,868,534,184,0,82,5,28,35,466,222,55,0,0,1,152,36
250277325001,698,379,75,4,60,1,147,32,388,244,62,1,60,1,7,13,310,135,13,3,0,0,140,19
250277325002,1078,555,130,19,89,0,183,102,694,435,105,9,89,0,5,51,384,120,25,10,0,0,178,51
250277326001,1153,736,152,7,32,0,167,59,752,543,126,7,32,0,2,42,401,193,26,0,0,0,165,17
250277326002,1022,678,140,8,20,0,105,71,718,517,136,5,20,0,2,38,304,161,4,3,0,0,103,33
250277326003,815,579,93,8,35,0,51,49,640,488,82,4,35,0,5,26,175,91,11,4,0,0,46,23
250277326004,603,414,87,7,11,0,47,37,439,314,81,7,11,0,3,23,164,100,6,0,0,0,44,14
250277326005,660,428,56,4,30,0,92,50,428,324,50,1,30,0,3,20,232,104,6,3,0,0,89,30
250277327001,1153,755,181,0,73,0,95,49,867,597,156,0,72,0,5,37,286,158,25,0,1,0,90,12
250277327002,857,543,104,13,43,4,107,43,596,447,84,1,38,2,2,22,261,96,20,12,5,2,105,21
250277327003,1143,766,223,6,48,0,70,30,846,588,195,0,46,0,1,16,297,178,28,6,2,0,69,14
250277327004,785,459,195,4,35,0,63,29,583,346,180,4,35,0,1,17,202,113,15,0,0,0,62,12
250277328011,1908,1645,87,4,108,0,30,34,1803,1582,85,4,108,0,2,22,105,63,2,0,0,0,28,12
250277328012,2921,2217,377,3,170,0,90,64,2706,2081,359,3,170,0,42,51,215,136,18,0,0,0,48,13
250277328021,2241,1740,188,2,171,0,86,54,2077,1672,179,1,171,0,20,34,164,68,9,1,0,0,66,20
250277328022,1138,682,280,1,77,0,75,23,1006,636,265,0,77,0,12,16,132,46,15,1,0,0,63,7
250277328023,743,515,138,0,15,0,49,26,631,459,129,0,15,0,7,21,112,56,9,0,0,0,42,5
250277329011,1013,717,139,0,35,0,82,40,851,659,130,0,33,0,13,16,162,58,9,0,2,0,69,24
250277329012,2360,1708,372,3,113,0,100,64,2047,1513,361,1,113,0,18,41,313,195,11,2,0,0,82,23
250277329013,943,648,148,10,34,1,61,41,779,566,137,6,34,1,7,28,164,82,11,4,0,0,54,13
250277329014,1290,1057,110,11,34,0,48,30,1187,1012,108,11,34,0,3,19,103,45,2,0,0,0,45,11
250277329015,986,492,168,5,123,0,136,62,612,324,141,1,123,0,0,23,374,168,27,4,0,0,136,39
250277329021,2459,2116,114,3,120,1,55,50,2249,1993,98,3,117,0,3,35,210,123,16,0,3,1,52,15
250277330001,840,417,116,7,84,0,171,45,465,279,75,1,83,0,9,18,375,138,41,6,1,0,162,27
250277330002,1493,936,144,8,133,1,154,117,1013,694,131,1,133,1,0,53,480,242,13,7,0,0,154,64
250277330003,1429,558,180,11,235,0,356,89,898,440,161,5,233,0,26,33,531,118,19,6,2,0,330,56
250277331011,953,756,60,4,50,0,61,22,819,687,56,2,50,0,12,12,134,69,4,2,0,0,49,10
250277331012,1105,887,76,8,46,1,41,46,984,830,69,3,46,1,11,24,121,57,7,5,0,0,30,22
250277331021,766,492,96,2,83,0,74,19,627,429,95,2,82,0,8,11,139,63,1,0,1,0,66,8
250277331022,1458,1128,106,2,117,0,72,33,1305,1058,99,2,117,0,6,23,153,70,7,0,0,0,66,10
250277351001,1050,971,22,0,13,0,21,23,1001,951,18,0,13,0,3,16,49,20,4,0,0,0,18,7
250277351002,1211,1165,9,5,5,0,20,7,1157,1133,9,5,5,0,2,3,54,32,0,0,0,0,18,4
250277351003,2557,2397,27,9,59,1,20,44,2494,2350,26,9,59,0,9,41,63,47,1,0,0,1,11,3
250277351004,1895,1798,27,4,29,0,11,26,1838,1762,23,4,29,0,1,19,57,36,4,0,0,0,10,7
250277352001,1216,1133,12,2,28,0,7,34,1169,1104,11,2,28,0,0,24,47,29,1,0,0,0,7,10
250277352002,909,839,18,0,26,6,8,12,863,806,16,0,26,6,0,9,46,33,2,0,0,0,8,3
250277352003,1301,1121,107,2,6,0,42,23,1236,1094,105,2,6,0,7,22,65,27,2,0,0,0,35,1
250277352004,831,781,6,9,15,0,11,9,798,761,5,9,15,0,1,7,33,20,1,0,0,0,10,2
250277361001,818,756,25,0,15,0,7,15,785,738,18,0,15,0,0,14,33,18,7,0,0,0,7,1
250277361002,1040,999,5,0,28,0,1,7,1021,982,5,0,28,0,0,6,19,17,0,0,0,0,1,1
250277361003,742,698,8,0,22,0,2,12,727,688,4,0,22,0,1,12,15,10,4,0,0,0,1,0
250277362001,858,816,16,1,5,1,5,14,841,809,15,1,5,1,0,10,17,7,1,0,0,0,5,4
250277362002,1458,1379,13,1,37,0,11,17,1425,1360,12,1,37,0,0,15,33,19,1,0,0,0,11,2
250277362003,1406,1317,11,5,20,0,9,44,1371,1301,11,5,20,0,5,29,35,16,0,0,0,0,4,15
250277363001,1054,993,10,0,15,0,10,26,1004,960,7,0,15,0,2,20,50,33,3,0,0,0,8,6
250277363002,611,579,8,5,10,0,2,7,599,567,8,5,10,0,2,7,12,12,0,0,0,0,0,0
250277363003,761,723,6,3,10,2,9,8,716,685,5,3,10,2,3,8,45,38,1,0,0,0,6,0
250277364001,723,653,21,5,19,0,16,9,676,633,16,4,19,0,0,4,47,20,5,1,0,0,16,5
250277364002,1533,1442,17,0,51,0,7,16,1501,1415,16,0,51,0,3,16,32,27,1,0,0,0,4,0
250277364003,815,789,7,1,6,0,0,12,791,767,7,1,6,0,0,10,24,22,0,0,0,0,0,2
250277365001,621,593,2,1,19,0,1,5,610,583,2,1,19,0,0,5,11,10,0,0,0,0,1,0
250277365002,626,610,0,1,11,0,4,0,613,602,0,0,11,0,0,0,13,8,0,1,0,0,4,0
250277365003,937,903,9,0,9,0,4,12,923,896,9,0,9,0,0,9,14,7,0,0,0,0,4,3
250277365004,1175,1125,15,0,19,0,3,13,1168,1119,15,0,19,0,3,12,7,6,0,0,0,0,0,1
250277365005,1010,991,5,0,3,0,5,6,991,977,4,0,3,0,1,6,19,14,1,0,0,0,4,0
250277371001,744,713,10,0,1,0,2,18,736,709,10,0,1,0,0,16,8,4,0,0,0,0,2,2
250277371002,1003,922,18,0,28,1,10,24,975,911,15,0,28,1,1,19,28,11,3,0,0,0,9,5
250277371003,1801,1712,26,2,29,1,11,20,1751,1685,22,2,29,0,2,11,50,27,4,0,0,1,9,9
250277371004,1568,1505,11,2,15,0,9,26,1542,1488,10,2,15,0,1,26,26,17,1,0,0,0,8,0
250277372001,798,744,21,2,12,0,4,15,773,732,19,1,12,0,0,9,25,12,2,1,0,0,4,6
250277372002,949,910,5,3,7,4,3,17,936,899,3,3,7,4,3,17,13,11,2,0,0,0,0,0
250277373001,1502,1395,35,5,34,0,18,15,1446,1356,35,1,34,0,7,13,56,39,0,4,0,0,11,2
250277373002,1469,1378,11,1,35,0,14,30,1436,1358,11,1,35,0,4,27,33,20,0,0,0,0,10,3
250277373003,1536,1449,26,8,20,3,15,15,1500,1423,26,7,20,3,7,14,36,26,0,1,0,0,8,1
250277373004,1891,1769,14,3,67,0,4,34,1860,1748,14,3,67,0,2,26,31,21,0,0,0,0,2,8
250277381001,1097,1029,4,1,30,2,13,18,1058,1000,4,0,30,2,5,17,39,29,0,1,0,0,8,1
250277381002,1424,1122,30,5,210,0,15,42,1367,1086,28,4,210,0,3,36,57,36,2,1,0,0,12,6
250277381003,2115,1501,23,10,515,0,16,50,2055,1468,21,2,515,0,4,45,60,33,2,8,0,0,12,5
250277382011,2017,1896,14,0,73,0,4,30,1980,1869,14,0,73,0,0,24,37,27,0,0,0,0,4,6
250277382012,2058,1842,37,1,143,0,5,30,2017,1811,31,1,143,0,1,30,41,31,6,0,0,0,4,0
250277382021,3693,3344,25,2,238,0,24,60,3631,3308,25,2,238,0,8,50,62,36,0,0,0,0,16,10
250277382022,2302,2151,29,1,76,0,22,23,2271,2133,29,1,76,0,10,22,31,18,0,0,0,0,12,1
250277391001,1279,1112,27,1,89,0,30,20,1260,1100,27,1,89,0,23,20,19,12,0,0,0,0,7,0
250277391002,1098,906,10,2,150,0,14,16,1064,879,10,2,150,0,9,14,34,27,0,0,0,0,5,2
250277391003,2518,1798,23,2,612,5,33,45,2449,1748,23,2,612,5,15,44,69,50,0,0,0,0,18,1
250277391004,2381,1587,170,5,534,0,22,63,2270,1510,166,5,534,0,3,52,111,77,4,0,0,0,19,11
250277391005,2281,1372,84,4,707,0,64,50,2234,1348,82,4,707,0,50,43,47,24,2,0,0,0,14,7
250277392001,962,801,26,0,99,0,27,9,922,779,20,0,99,0,17,7,40,22,6,0,0,0,10,2
250277392002,1866,1457,46,0,293,0,30,40,1818,1433,44,0,293,0,15,33,48,24,2,0,0,0,15,7
